"Area","Year","Month","Labor Force","Employed","Unemployed","Area Rate","Massachusetts Rate"
"BARNSTABLE COUNTY","2020","January","108402","101485","6917","6.4","3.5"
"BARNSTABLE COUNTY","2020","February","107945","101342","6603","6.1","3.3"
"BARNSTABLE COUNTY","2020","March","106633","99983","6650","6.2","3.6"
"BARNSTABLE COUNTY","2020","April","98702","76576","22126","22.4","16.7"
"BARNSTABLE COUNTY","2020","May","107242","87171","20071","18.7","15.6"
"BARNSTABLE COUNTY","2020","June","115575","97961","17614","15.2","14.5"
"BARNSTABLE COUNTY","2020","July","120814","106307","14507","12.0","13.0"
"BARNSTABLE COUNTY","2020","August","119721","108468","11253","9.4","10.3"
"BARNSTABLE COUNTY","2020","September","114114","103658","10456","9.2","9.8"
"BARNSTABLE COUNTY","2020","October","111106","102354","8752","7.9","8.1"
"BARNSTABLE COUNTY","2020","November","107492","98714","8778","8.2","7.6"
"BARNSTABLE COUNTY","2020","December","107868","98520","9348","8.7","7.4"
"BARNSTABLE COUNTY","2020","Annual","110468","98545","11923","10.8","9.4"
"BARNSTABLE COUNTY","2019","January","110737","102919","7818","7.1","4.0"
"BARNSTABLE COUNTY","2019","February","109304","101892","7412","6.8","3.6"
"BARNSTABLE COUNTY","2019","March","109052","102559","6493","6.0","3.4"
"BARNSTABLE COUNTY","2019","April","110712","106094","4618","4.2","2.8"
"BARNSTABLE COUNTY","2019","May","115238","111293","3945","3.4","2.9"
"BARNSTABLE COUNTY","2019","June","123800","119890","3910","3.2","3.2"
"BARNSTABLE COUNTY","2019","July","130411","126584","3827","2.9","3.3"
"BARNSTABLE COUNTY","2019","August","128706","125274","3432","2.7","3.0"
"BARNSTABLE COUNTY","2019","September","116996","113756","3240","2.8","2.8"
"BARNSTABLE COUNTY","2019","October","113393","110206","3187","2.8","2.6"
"BARNSTABLE COUNTY","2019","November","109582","105598","3984","3.6","2.5"
"BARNSTABLE COUNTY","2019","December","109650","104986","4664","4.3","2.6"
"BARNSTABLE COUNTY","2019","Annual","115632","110921","4711","4.1","3.1"
"BARNSTABLE COUNTY","2018","January","109380","101369","8011","7.3","4.3"
"BARNSTABLE COUNTY","2018","February","108840","100816","8024","7.4","4.2"
"BARNSTABLE COUNTY","2018","March","109088","102038","7050","6.5","3.8"
"BARNSTABLE COUNTY","2018","April","111171","105981","5190","4.7","3.3"
"BARNSTABLE COUNTY","2018","May","115367","110905","4462","3.9","3.3"
"BARNSTABLE COUNTY","2018","June","124399","119894","4505","3.6","3.7"
"BARNSTABLE COUNTY","2018","July","130921","126758","4163","3.2","3.7"
"BARNSTABLE COUNTY","2018","August","129201","125465","3736","2.9","3.3"
"BARNSTABLE COUNTY","2018","September","118457","114780","3677","3.1","3.2"
"BARNSTABLE COUNTY","2018","October","114602","111037","3565","3.1","2.9"
"BARNSTABLE COUNTY","2018","November","111440","107170","4270","3.8","2.8"
"BARNSTABLE COUNTY","2018","December","112089","106836","5253","4.7","3.0"
"BARNSTABLE COUNTY","2018","Annual","116246","111087","5159","4.4","3.4"
"BARNSTABLE COUNTY","2017","January","107081","98862","8219","7.7","4.5"
"BARNSTABLE COUNTY","2017","February","106606","98556","8050","7.6","4.4"
"BARNSTABLE COUNTY","2017","March","107441","100378","7063","6.6","4.0"
"BARNSTABLE COUNTY","2017","April","108981","103669","5312","4.9","3.6"
"BARNSTABLE COUNTY","2017","May","112553","107791","4762","4.2","3.7"
"BARNSTABLE COUNTY","2017","June","122351","117765","4586","3.7","4.0"
"BARNSTABLE COUNTY","2017","July","128450","123986","4464","3.5","4.1"
"BARNSTABLE COUNTY","2017","August","128097","123838","4259","3.3","3.8"
"BARNSTABLE COUNTY","2017","September","116771","112607","4164","3.6","3.7"
"BARNSTABLE COUNTY","2017","October","112606","108658","3948","3.5","3.3"
"BARNSTABLE COUNTY","2017","November","110447","105558","4889","4.4","3.3"
"BARNSTABLE COUNTY","2017","December","110162","104459","5703","5.2","3.4"
"BARNSTABLE COUNTY","2017","Annual","114296","108844","5452","4.8","3.8"
"BARNSTABLE COUNTY","2016","January","105055","96259","8796","8.4","4.9"
"BARNSTABLE COUNTY","2016","February","104654","96142","8512","8.1","4.7"
"BARNSTABLE COUNTY","2016","March","106145","98232","7913","7.5","4.5"
"BARNSTABLE COUNTY","2016","April","107095","101327","5768","5.4","3.9"
"BARNSTABLE COUNTY","2016","May","110025","105168","4857","4.4","3.9"
"BARNSTABLE COUNTY","2016","June","118556","113760","4796","4.0","4.2"
"BARNSTABLE COUNTY","2016","July","125732","121127","4605","3.7","4.2"
"BARNSTABLE COUNTY","2016","August","124919","120784","4135","3.3","3.8"
"BARNSTABLE COUNTY","2016","September","113410","109193","4217","3.7","3.8"
"BARNSTABLE COUNTY","2016","October","109975","105992","3983","3.6","3.5"
"BARNSTABLE COUNTY","2016","November","107456","102716","4740","4.4","3.3"
"BARNSTABLE COUNTY","2016","December","107100","101424","5676","5.3","3.5"
"BARNSTABLE COUNTY","2016","Annual","111677","106010","5667","5.1","4.0"
"BARNSTABLE COUNTY","2015","January","106819","96517","10302","9.6","5.8"
"BARNSTABLE COUNTY","2015","February","105508","95465","10043","9.5","5.5"
"BARNSTABLE COUNTY","2015","March","105416","96299","9117","8.6","5.2"
"BARNSTABLE COUNTY","2015","April","107434","100734","6700","6.2","4.6"
"BARNSTABLE COUNTY","2015","May","112258","106017","6241","5.6","4.9"
"BARNSTABLE COUNTY","2015","June","119190","113347","5843","4.9","5.0"
"BARNSTABLE COUNTY","2015","July","124725","119075","5650","4.5","5.0"
"BARNSTABLE COUNTY","2015","August","123605","118606","4999","4.0","4.5"
"BARNSTABLE COUNTY","2015","September","112574","107502","5072","4.5","4.5"
"BARNSTABLE COUNTY","2015","October","109124","104062","5062","4.6","4.2"
"BARNSTABLE COUNTY","2015","November","106637","100631","6006","5.6","4.1"
"BARNSTABLE COUNTY","2015","December","106330","99636","6694","6.3","4.1"
"BARNSTABLE COUNTY","2015","Annual","111635","104824","6811","6.1","4.8"
"BARNSTABLE COUNTY","2014","January","105344","94142","11202","10.6","6.7"
"BARNSTABLE COUNTY","2014","February","105265","93878","11387","10.8","6.7"
"BARNSTABLE COUNTY","2014","March","106258","95474","10784","10.1","6.4"
"BARNSTABLE COUNTY","2014","April","107306","99395","7911","7.4","5.5"
"BARNSTABLE COUNTY","2014","May","111675","104451","7224","6.5","5.7"
"BARNSTABLE COUNTY","2014","June","119113","112155","6958","5.8","5.9"
"BARNSTABLE COUNTY","2014","July","125082","118078","7004","5.6","6.1"
"BARNSTABLE COUNTY","2014","August","123715","117257","6458","5.2","5.7"
"BARNSTABLE COUNTY","2014","September","113757","107444","6313","5.5","5.5"
"BARNSTABLE COUNTY","2014","October","111137","105022","6115","5.5","5.0"
"BARNSTABLE COUNTY","2014","November","108950","101735","7215","6.6","4.9"
"BARNSTABLE COUNTY","2014","December","107952","100176","7776","7.2","4.8"
"BARNSTABLE COUNTY","2014","Annual","112130","104101","8029","7.2","5.7"
"BARNSTABLE COUNTY","2013","January","104744","92252","12492","11.9","7.6"
"BARNSTABLE COUNTY","2013","February","103613","91347","12266","11.8","7.2"
"BARNSTABLE COUNTY","2013","March","103769","92426","11343","10.9","6.9"
"BARNSTABLE COUNTY","2013","April","105000","96134","8866","8.4","6.3"
"BARNSTABLE COUNTY","2013","May","108177","100018","8159","7.5","6.6"
"BARNSTABLE COUNTY","2013","June","114840","106670","8170","7.1","7.1"
"BARNSTABLE COUNTY","2013","July","120171","112276","7895","6.6","7.0"
"BARNSTABLE COUNTY","2013","August","118485","111163","7322","6.2","6.5"
"BARNSTABLE COUNTY","2013","September","109411","101957","7454","6.8","6.5"
"BARNSTABLE COUNTY","2013","October","106082","98707","7375","7.0","6.2"
"BARNSTABLE COUNTY","2013","November","104591","96087","8504","8.1","5.9"
"BARNSTABLE COUNTY","2013","December","104406","95508","8898","8.5","5.9"
"BARNSTABLE COUNTY","2013","Annual","108607","99545","9062","8.3","6.6"
"BARNSTABLE COUNTY","2012","January","103322","91245","12077","11.7","7.4"
"BARNSTABLE COUNTY","2012","February","103172","91148","12024","11.7","7.3"
"BARNSTABLE COUNTY","2012","March","103946","92507","11439","11.0","6.9"
"BARNSTABLE COUNTY","2012","April","105245","96308","8937","8.5","6.3"
"BARNSTABLE COUNTY","2012","May","108265","99757","8508","7.9","6.5"
"BARNSTABLE COUNTY","2012","June","115783","107536","8247","7.1","6.9"
"BARNSTABLE COUNTY","2012","July","119973","111784","8189","6.8","7.1"
"BARNSTABLE COUNTY","2012","August","118915","111294","7621","6.4","6.7"
"BARNSTABLE COUNTY","2012","September","109969","102368","7601","6.9","6.5"
"BARNSTABLE COUNTY","2012","October","107338","99694","7644","7.1","6.3"
"BARNSTABLE COUNTY","2012","November","105380","96533","8847","8.4","6.1"
"BARNSTABLE COUNTY","2012","December","105588","95605","9983","9.5","6.4"
"BARNSTABLE COUNTY","2012","Annual","108908","99648","9260","8.5","6.7"
"BARNSTABLE COUNTY","2011","January","105387","91773","13614","12.9","8.3"
"BARNSTABLE COUNTY","2011","February","104423","91075","13348","12.8","8.0"
"BARNSTABLE COUNTY","2011","March","105257","92598","12659","12.0","7.6"
"BARNSTABLE COUNTY","2011","April","106077","96323","9754","9.2","7.0"
"BARNSTABLE COUNTY","2011","May","108894","99775","9119","8.4","7.1"
"BARNSTABLE COUNTY","2011","June","116467","107606","8861","7.6","7.5"
"BARNSTABLE COUNTY","2011","July","121641","113120","8521","7.0","7.5"
"BARNSTABLE COUNTY","2011","August","121937","113754","8183","6.7","7.0"
"BARNSTABLE COUNTY","2011","September","111440","103218","8222","7.4","7.1"
"BARNSTABLE COUNTY","2011","October","108354","100376","7978","7.4","6.6"
"BARNSTABLE COUNTY","2011","November","106022","96976","9046","8.5","6.4"
"BARNSTABLE COUNTY","2011","December","105835","95769","10066","9.5","6.5"
"BARNSTABLE COUNTY","2011","Annual","110145","100197","9948","9.0","7.2"
"BARNSTABLE COUNTY","2010","January","105989","91580","14409","13.6","9.3"
"BARNSTABLE COUNTY","2010","February","104917","90817","14100","13.4","9.1"
"BARNSTABLE COUNTY","2010","March","105584","92114","13470","12.8","8.7"
"BARNSTABLE COUNTY","2010","April","107175","96423","10752","10.0","8.0"
"BARNSTABLE COUNTY","2010","May","110325","100621","9704","8.8","7.9"
"BARNSTABLE COUNTY","2010","June","117330","108144","9186","7.8","8.1"
"BARNSTABLE COUNTY","2010","July","123423","114327","9096","7.4","8.1"
"BARNSTABLE COUNTY","2010","August","122489","113934","8555","7.0","7.7"
"BARNSTABLE COUNTY","2010","September","113302","104458","8844","7.8","7.8"
"BARNSTABLE COUNTY","2010","October","108732","100041","8691","8.0","7.3"
"BARNSTABLE COUNTY","2010","November","106870","96378","10492","9.8","7.5"
"BARNSTABLE COUNTY","2010","December","106645","95504","11141","10.4","7.4"
"BARNSTABLE COUNTY","2010","Annual","111065","100362","10703","9.6","8.1"
"BARNSTABLE COUNTY","2009","January","114764","101897","12867","11.2","7.8"
"BARNSTABLE COUNTY","2009","February","113528","101128","12400","10.9","8.1"
"BARNSTABLE COUNTY","2009","March","113934","102222","11712","10.3","8.1"
"BARNSTABLE COUNTY","2009","April","115855","106446","9409","8.1","7.5"
"BARNSTABLE COUNTY","2009","May","120460","111715","8745","7.3","8.0"
"BARNSTABLE COUNTY","2009","June","130720","121685","9035","6.9","8.4"
"BARNSTABLE COUNTY","2009","July","138404","129630","8774","6.3","8.5"
"BARNSTABLE COUNTY","2009","August","137598","128975","8623","6.3","8.2"
"BARNSTABLE COUNTY","2009","September","125280","116173","9107","7.3","8.4"
"BARNSTABLE COUNTY","2009","October","120084","110956","9128","7.6","8.1"
"BARNSTABLE COUNTY","2009","November","117427","106635","10792","9.2","7.9"
"BARNSTABLE COUNTY","2009","December","116789","104761","12028","10.3","8.2"
"BARNSTABLE COUNTY","2009","Annual","122070","111852","10218","8.4","8.1"
"BARNSTABLE COUNTY","2008","January","113506","104983","8523","7.5","5.2"
"BARNSTABLE COUNTY","2008","February","112231","104001","8230","7.3","5.1"
"BARNSTABLE COUNTY","2008","March","113204","105328","7876","7.0","4.9"
"BARNSTABLE COUNTY","2008","April","115836","109332","6504","5.6","4.4"
"BARNSTABLE COUNTY","2008","May","120923","114909","6014","5.0","4.9"
"BARNSTABLE COUNTY","2008","June","130834","124314","6520","5.0","5.3"
"BARNSTABLE COUNTY","2008","July","137871","131738","6133","4.4","5.5"
"BARNSTABLE COUNTY","2008","August","136554","130518","6036","4.4","5.4"
"BARNSTABLE COUNTY","2008","September","125152","118531","6621","5.3","5.5"
"BARNSTABLE COUNTY","2008","October","120534","113713","6821","5.7","5.4"
"BARNSTABLE COUNTY","2008","November","117040","108465","8575","7.3","5.7"
"BARNSTABLE COUNTY","2008","December","116501","106343","10158","8.7","6.3"
"BARNSTABLE COUNTY","2008","Annual","121682","114348","7334","6.0","5.3"
"BARNSTABLE COUNTY","2007","January","114221","105541","8680","7.6","5.4"
"BARNSTABLE COUNTY","2007","February","113073","105055","8018","7.1","5.1"
"BARNSTABLE COUNTY","2007","March","113849","106598","7251","6.4","4.7"
"BARNSTABLE COUNTY","2007","April","115839","109943","5896","5.1","4.3"
"BARNSTABLE COUNTY","2007","May","119865","114542","5323","4.4","4.3"
"BARNSTABLE COUNTY","2007","June","130783","125259","5524","4.2","4.6"
"BARNSTABLE COUNTY","2007","July","137031","131956","5075","3.7","4.7"
"BARNSTABLE COUNTY","2007","August","135346","130879","4467","3.3","4.3"
"BARNSTABLE COUNTY","2007","September","124751","119909","4842","3.9","4.4"
"BARNSTABLE COUNTY","2007","October","119723","115328","4395","3.7","4.0"
"BARNSTABLE COUNTY","2007","November","116614","111114","5500","4.7","4.0"
"BARNSTABLE COUNTY","2007","December","114769","108282","6487","5.7","4.3"
"BARNSTABLE COUNTY","2007","Annual","121322","115367","5955","4.9","4.5"
"BARNSTABLE COUNTY","2006","January","115252","106850","8402","7.3","5.3"
"BARNSTABLE COUNTY","2006","February","113796","105659","8137","7.2","5.3"
"BARNSTABLE COUNTY","2006","March","114650","106915","7735","6.7","5.0"
"BARNSTABLE COUNTY","2006","April","117616","111031","6585","5.6","4.6"
"BARNSTABLE COUNTY","2006","May","120868","115190","5678","4.7","4.6"
"BARNSTABLE COUNTY","2006","June","129788","124042","5746","4.4","4.8"
"BARNSTABLE COUNTY","2006","July","136850","131615","5235","3.8","5.0"
"BARNSTABLE COUNTY","2006","August","136396","131466","4930","3.6","4.6"
"BARNSTABLE COUNTY","2006","September","125136","119959","5177","4.1","4.7"
"BARNSTABLE COUNTY","2006","October","121623","116967","4656","3.8","4.1"
"BARNSTABLE COUNTY","2006","November","118364","112389","5975","5.0","4.3"
"BARNSTABLE COUNTY","2006","December","117055","110316","6739","5.8","4.3"
"BARNSTABLE COUNTY","2006","Annual","122283","116033","6250","5.1","4.7"
"BARNSTABLE COUNTY","2005","January","114489","106361","8128","7.1","5.5"
"BARNSTABLE COUNTY","2005","February","113029","105020","8009","7.1","5.5"
"BARNSTABLE COUNTY","2005","March","113601","106173","7428","6.5","5.1"
"BARNSTABLE COUNTY","2005","April","117257","111319","5938","5.1","4.6"
"BARNSTABLE COUNTY","2005","May","120394","115199","5195","4.3","4.7"
"BARNSTABLE COUNTY","2005","June","129974","124605","5369","4.1","4.9"
"BARNSTABLE COUNTY","2005","July","137809","132781","5028","3.6","4.9"
"BARNSTABLE COUNTY","2005","August","136794","132251","4543","3.3","4.5"
"BARNSTABLE COUNTY","2005","September","126138","121094","5044","4.0","4.8"
"BARNSTABLE COUNTY","2005","October","121433","116703","4730","3.9","4.3"
"BARNSTABLE COUNTY","2005","November","117853","111762","6091","5.2","4.5"
"BARNSTABLE COUNTY","2005","December","116937","110179","6758","5.8","4.5"
"BARNSTABLE COUNTY","2005","Annual","122143","116121","6022","4.9","4.8"
"BARNSTABLE COUNTY","2004","January","116285","107438","8847","7.6","6.1"
"BARNSTABLE COUNTY","2004","February","115049","106809","8240","7.2","5.8"
"BARNSTABLE COUNTY","2004","March","115795","107771","8024","6.9","5.7"
"BARNSTABLE COUNTY","2004","April","118248","112150","6098","5.2","5.0"
"BARNSTABLE COUNTY","2004","May","122242","116732","5510","4.5","5.0"
"BARNSTABLE COUNTY","2004","June","131305","125527","5778","4.4","5.4"
"BARNSTABLE COUNTY","2004","July","137786","132577","5209","3.8","5.3"
"BARNSTABLE COUNTY","2004","August","137687","132850","4837","3.5","4.8"
"BARNSTABLE COUNTY","2004","September","126492","121856","4636","3.7","4.8"
"BARNSTABLE COUNTY","2004","October","122188","117742","4446","3.6","4.4"
"BARNSTABLE COUNTY","2004","November","118743","113153","5590","4.7","4.5"
"BARNSTABLE COUNTY","2004","December","117385","111179","6206","5.3","4.5"
"BARNSTABLE COUNTY","2004","Annual","123267","117149","6118","5.0","5.1"
"BARNSTABLE COUNTY","2003","January","114093","105564","8529","7.5","6.3"
"BARNSTABLE COUNTY","2003","February","112738","104700","8038","7.1","6.1"
"BARNSTABLE COUNTY","2003","March","113373","105631","7742","6.8","6.0"
"BARNSTABLE COUNTY","2003","April","116143","109747","6396","5.5","5.5"
"BARNSTABLE COUNTY","2003","May","120640","114925","5715","4.7","5.7"
"BARNSTABLE COUNTY","2003","June","130897","124859","6038","4.6","6.2"
"BARNSTABLE COUNTY","2003","July","136946","131680","5266","3.8","6.0"
"BARNSTABLE COUNTY","2003","August","137378","132309","5069","3.7","5.6"
"BARNSTABLE COUNTY","2003","September","126508","121331","5177","4.1","5.7"
"BARNSTABLE COUNTY","2003","October","122754","117809","4945","4.0","5.2"
"BARNSTABLE COUNTY","2003","November","119506","113165","6341","5.3","5.2"
"BARNSTABLE COUNTY","2003","December","118090","111229","6861","5.8","5.1"
"BARNSTABLE COUNTY","2003","Annual","122422","116079","6343","5.2","5.7"
"BARNSTABLE COUNTY","2002","January","109086","101899","7187","6.6","5.6"
"BARNSTABLE COUNTY","2002","February","108572","101688","6884","6.3","5.4"
"BARNSTABLE COUNTY","2002","March","109770","102940","6830","6.2","5.4"
"BARNSTABLE COUNTY","2002","April","112299","106652","5647","5.0","5.0"
"BARNSTABLE COUNTY","2002","May","116980","112122","4858","4.2","4.9"
"BARNSTABLE COUNTY","2002","June","127330","122166","5164","4.1","5.4"
"BARNSTABLE COUNTY","2002","July","134964","130087","4877","3.6","5.4"
"BARNSTABLE COUNTY","2002","August","133482","129108","4374","3.3","5.1"
"BARNSTABLE COUNTY","2002","September","123755","119073","4682","3.8","5.2"
"BARNSTABLE COUNTY","2002","October","119496","115173","4323","3.6","4.9"
"BARNSTABLE COUNTY","2002","November","116148","110394","5754","5.0","5.1"
"BARNSTABLE COUNTY","2002","December","115080","108710","6370","5.5","5.3"
"BARNSTABLE COUNTY","2002","Annual","118913","113334","5579","4.7","5.2"
"BARNSTABLE COUNTY","2001","January","106418","100049","6369","6.0","3.7"
"BARNSTABLE COUNTY","2001","February","105873","99791","6082","5.7","3.5"
"BARNSTABLE COUNTY","2001","March","107124","101308","5816","5.4","3.6"
"BARNSTABLE COUNTY","2001","April","108912","104395","4517","4.1","3.2"
"BARNSTABLE COUNTY","2001","May","112812","109000","3812","3.4","3.3"
"BARNSTABLE COUNTY","2001","June","122924","119115","3809","3.1","3.8"
"BARNSTABLE COUNTY","2001","July","129490","125851","3639","2.8","3.9"
"BARNSTABLE COUNTY","2001","August","127105","123762","3343","2.6","3.9"
"BARNSTABLE COUNTY","2001","September","118722","115289","3433","2.9","4.0"
"BARNSTABLE COUNTY","2001","October","114352","111069","3283","2.9","4.0"
"BARNSTABLE COUNTY","2001","November","111626","107131","4495","4.0","4.2"
"BARNSTABLE COUNTY","2001","December","110583","105434","5149","4.7","4.4"
"BARNSTABLE COUNTY","2001","Annual","114662","110183","4479","3.9","3.8"
"BERKSHIRE COUNTY","2020","January","63860","60907","2953","4.6","3.5"
"BERKSHIRE COUNTY","2020","February","63727","60966","2761","4.3","3.3"
"BERKSHIRE COUNTY","2020","March","62586","59692","2894","4.6","3.6"
"BERKSHIRE COUNTY","2020","April","56908","46716","10192","17.9","16.7"
"BERKSHIRE COUNTY","2020","May","60150","50893","9257","15.4","15.6"
"BERKSHIRE COUNTY","2020","June","63534","54811","8723","13.7","14.5"
"BERKSHIRE COUNTY","2020","July","64930","56514","8416","13.0","13.0"
"BERKSHIRE COUNTY","2020","August","63975","57358","6617","10.3","10.3"
"BERKSHIRE COUNTY","2020","September","62629","56550","6079","9.7","9.8"
"BERKSHIRE COUNTY","2020","October","62549","57375","5174","8.3","8.1"
"BERKSHIRE COUNTY","2020","November","61672","56613","5059","8.2","7.6"
"BERKSHIRE COUNTY","2020","December","61928","56801","5127","8.3","7.4"
"BERKSHIRE COUNTY","2020","Annual","62370","56266","6104","9.8","9.4"
"BERKSHIRE COUNTY","2019","January","65417","62055","3362","5.1","4.0"
"BERKSHIRE COUNTY","2019","February","64847","61694","3153","4.9","3.6"
"BERKSHIRE COUNTY","2019","March","64541","61652","2889","4.5","3.4"
"BERKSHIRE COUNTY","2019","April","63667","61367","2300","3.6","2.8"
"BERKSHIRE COUNTY","2019","May","64365","62152","2213","3.4","2.9"
"BERKSHIRE COUNTY","2019","June","66891","64500","2391","3.6","3.2"
"BERKSHIRE COUNTY","2019","July","67941","65592","2349","3.5","3.3"
"BERKSHIRE COUNTY","2019","August","66931","64692","2239","3.3","3.0"
"BERKSHIRE COUNTY","2019","September","63913","61880","2033","3.2","2.8"
"BERKSHIRE COUNTY","2019","October","63695","61836","1859","2.9","2.6"
"BERKSHIRE COUNTY","2019","November","62909","60959","1950","3.1","2.5"
"BERKSHIRE COUNTY","2019","December","63047","60824","2223","3.5","2.6"
"BERKSHIRE COUNTY","2019","Annual","64847","62434","2413","3.7","3.1"
"BERKSHIRE COUNTY","2018","January","65306","61688","3618","5.5","4.3"
"BERKSHIRE COUNTY","2018","February","65034","61451","3583","5.5","4.2"
"BERKSHIRE COUNTY","2018","March","64648","61315","3333","5.2","3.8"
"BERKSHIRE COUNTY","2018","April","63780","60954","2826","4.4","3.3"
"BERKSHIRE COUNTY","2018","May","64838","62209","2629","4.1","3.3"
"BERKSHIRE COUNTY","2018","June","67238","64434","2804","4.2","3.7"
"BERKSHIRE COUNTY","2018","July","68719","66078","2641","3.8","3.7"
"BERKSHIRE COUNTY","2018","August","67558","65197","2361","3.5","3.3"
"BERKSHIRE COUNTY","2018","September","64790","62466","2324","3.6","3.2"
"BERKSHIRE COUNTY","2018","October","65088","62934","2154","3.3","2.9"
"BERKSHIRE COUNTY","2018","November","64741","62476","2265","3.5","2.8"
"BERKSHIRE COUNTY","2018","December","65395","62718","2677","4.1","3.0"
"BERKSHIRE COUNTY","2018","Annual","65595","62827","2768","4.2","3.4"
"BERKSHIRE COUNTY","2017","January","65005","61348","3657","5.6","4.5"
"BERKSHIRE COUNTY","2017","February","64653","60989","3664","5.7","4.4"
"BERKSHIRE COUNTY","2017","March","64420","61039","3381","5.2","4.0"
"BERKSHIRE COUNTY","2017","April","63993","61066","2927","4.6","3.6"
"BERKSHIRE COUNTY","2017","May","64510","61669","2841","4.4","3.7"
"BERKSHIRE COUNTY","2017","June","67286","64345","2941","4.4","4.0"
"BERKSHIRE COUNTY","2017","July","68452","65560","2892","4.2","4.1"
"BERKSHIRE COUNTY","2017","August","67622","64866","2756","4.1","3.8"
"BERKSHIRE COUNTY","2017","September","64936","62219","2717","4.2","3.7"
"BERKSHIRE COUNTY","2017","October","64606","62180","2426","3.8","3.3"
"BERKSHIRE COUNTY","2017","November","64539","62025","2514","3.9","3.3"
"BERKSHIRE COUNTY","2017","December","65123","62315","2808","4.3","3.4"
"BERKSHIRE COUNTY","2017","Annual","65428","62468","2960","4.5","3.8"
"BERKSHIRE COUNTY","2016","January","63900","60081","3819","6.0","4.9"
"BERKSHIRE COUNTY","2016","February","64219","60487","3732","5.8","4.7"
"BERKSHIRE COUNTY","2016","March","64169","60548","3621","5.6","4.5"
"BERKSHIRE COUNTY","2016","April","63117","60023","3094","4.9","3.9"
"BERKSHIRE COUNTY","2016","May","63502","60643","2859","4.5","3.9"
"BERKSHIRE COUNTY","2016","June","65779","62762","3017","4.6","4.2"
"BERKSHIRE COUNTY","2016","July","67043","64087","2956","4.4","4.2"
"BERKSHIRE COUNTY","2016","August","66357","63722","2635","4.0","3.8"
"BERKSHIRE COUNTY","2016","September","63711","61056","2655","4.2","3.8"
"BERKSHIRE COUNTY","2016","October","63645","61222","2423","3.8","3.5"
"BERKSHIRE COUNTY","2016","November","63397","60953","2444","3.9","3.3"
"BERKSHIRE COUNTY","2016","December","63912","61115","2797","4.4","3.5"
"BERKSHIRE COUNTY","2016","Annual","64396","61392","3004","4.7","4.0"
"BERKSHIRE COUNTY","2015","January","65397","60911","4486","6.9","5.8"
"BERKSHIRE COUNTY","2015","February","65497","61210","4287","6.5","5.5"
"BERKSHIRE COUNTY","2015","March","64908","60886","4022","6.2","5.2"
"BERKSHIRE COUNTY","2015","April","63957","60414","3543","5.5","4.6"
"BERKSHIRE COUNTY","2015","May","64905","61439","3466","5.3","4.9"
"BERKSHIRE COUNTY","2015","June","66490","63019","3471","5.2","5.0"
"BERKSHIRE COUNTY","2015","July","67914","64424","3490","5.1","5.0"
"BERKSHIRE COUNTY","2015","August","67315","64178","3137","4.7","4.5"
"BERKSHIRE COUNTY","2015","September","63810","60759","3051","4.8","4.5"
"BERKSHIRE COUNTY","2015","October","63774","60826","2948","4.6","4.2"
"BERKSHIRE COUNTY","2015","November","63822","60759","3063","4.8","4.1"
"BERKSHIRE COUNTY","2015","December","63741","60521","3220","5.1","4.1"
"BERKSHIRE COUNTY","2015","Annual","65127","61612","3515","5.4","4.8"
"BERKSHIRE COUNTY","2014","January","64675","59568","5107","7.9","6.7"
"BERKSHIRE COUNTY","2014","February","65141","59938","5203","8.0","6.7"
"BERKSHIRE COUNTY","2014","March","65103","60082","5021","7.7","6.4"
"BERKSHIRE COUNTY","2014","April","64152","59797","4355","6.8","5.5"
"BERKSHIRE COUNTY","2014","May","65298","60974","4324","6.6","5.7"
"BERKSHIRE COUNTY","2014","June","67061","62722","4339","6.5","5.9"
"BERKSHIRE COUNTY","2014","July","67829","63415","4414","6.5","6.1"
"BERKSHIRE COUNTY","2014","August","67411","63388","4023","6.0","5.7"
"BERKSHIRE COUNTY","2014","September","65143","61264","3879","6.0","5.5"
"BERKSHIRE COUNTY","2014","October","65080","61524","3556","5.5","5.0"
"BERKSHIRE COUNTY","2014","November","65057","61377","3680","5.7","4.9"
"BERKSHIRE COUNTY","2014","December","65506","61719","3787","5.8","4.8"
"BERKSHIRE COUNTY","2014","Annual","65621","61314","4307","6.6","5.7"
"BERKSHIRE COUNTY","2013","January","65329","59546","5783","8.9","7.6"
"BERKSHIRE COUNTY","2013","February","65633","60205","5428","8.3","7.2"
"BERKSHIRE COUNTY","2013","March","65111","59870","5241","8.0","6.9"
"BERKSHIRE COUNTY","2013","April","64949","60278","4671","7.2","6.3"
"BERKSHIRE COUNTY","2013","May","65721","60975","4746","7.2","6.6"
"BERKSHIRE COUNTY","2013","June","67419","62469","4950","7.3","7.1"
"BERKSHIRE COUNTY","2013","July","68254","63389","4865","7.1","7.0"
"BERKSHIRE COUNTY","2013","August","67262","62748","4514","6.7","6.5"
"BERKSHIRE COUNTY","2013","September","64754","60215","4539","7.0","6.5"
"BERKSHIRE COUNTY","2013","October","64188","59864","4324","6.7","6.2"
"BERKSHIRE COUNTY","2013","November","64139","59773","4366","6.8","5.9"
"BERKSHIRE COUNTY","2013","December","64701","60297","4404","6.8","5.9"
"BERKSHIRE COUNTY","2013","Annual","65621","60802","4819","7.3","6.6"
"BERKSHIRE COUNTY","2012","January","66842","61225","5617","8.4","7.4"
"BERKSHIRE COUNTY","2012","February","66881","61312","5569","8.3","7.3"
"BERKSHIRE COUNTY","2012","March","66354","61044","5310","8.0","6.9"
"BERKSHIRE COUNTY","2012","April","65407","60785","4622","7.1","6.3"
"BERKSHIRE COUNTY","2012","May","66223","61498","4725","7.1","6.5"
"BERKSHIRE COUNTY","2012","June","67995","63059","4936","7.3","6.9"
"BERKSHIRE COUNTY","2012","July","68782","63727","5055","7.3","7.1"
"BERKSHIRE COUNTY","2012","August","68050","63387","4663","6.9","6.7"
"BERKSHIRE COUNTY","2012","September","65657","61000","4657","7.1","6.5"
"BERKSHIRE COUNTY","2012","October","65343","60891","4452","6.8","6.3"
"BERKSHIRE COUNTY","2012","November","65012","60554","4458","6.9","6.1"
"BERKSHIRE COUNTY","2012","December","65420","60565","4855","7.4","6.4"
"BERKSHIRE COUNTY","2012","Annual","66497","61587","4910","7.4","6.7"
"BERKSHIRE COUNTY","2011","January","66981","60644","6337","9.5","8.3"
"BERKSHIRE COUNTY","2011","February","66647","60537","6110","9.2","8.0"
"BERKSHIRE COUNTY","2011","March","66325","60441","5884","8.9","7.6"
"BERKSHIRE COUNTY","2011","April","65695","60467","5228","8.0","7.0"
"BERKSHIRE COUNTY","2011","May","66091","60984","5107","7.7","7.1"
"BERKSHIRE COUNTY","2011","June","68522","63218","5304","7.7","7.5"
"BERKSHIRE COUNTY","2011","July","69129","63924","5205","7.5","7.5"
"BERKSHIRE COUNTY","2011","August","68824","63924","4900","7.1","7.0"
"BERKSHIRE COUNTY","2011","September","66077","61165","4912","7.4","7.1"
"BERKSHIRE COUNTY","2011","October","66275","61681","4594","6.9","6.6"
"BERKSHIRE COUNTY","2011","November","66221","61632","4589","6.9","6.4"
"BERKSHIRE COUNTY","2011","December","67047","62207","4840","7.2","6.5"
"BERKSHIRE COUNTY","2011","Annual","66986","61735","5251","7.8","7.2"
"BERKSHIRE COUNTY","2010","January","67075","60376","6699","10.0","9.3"
"BERKSHIRE COUNTY","2010","February","66982","60330","6652","9.9","9.1"
"BERKSHIRE COUNTY","2010","March","67057","60541","6516","9.7","8.7"
"BERKSHIRE COUNTY","2010","April","66880","61147","5733","8.6","8.0"
"BERKSHIRE COUNTY","2010","May","67028","61550","5478","8.2","7.9"
"BERKSHIRE COUNTY","2010","June","69594","63987","5607","8.1","8.1"
"BERKSHIRE COUNTY","2010","July","70757","65109","5648","8.0","8.1"
"BERKSHIRE COUNTY","2010","August","70084","64756","5328","7.6","7.7"
"BERKSHIRE COUNTY","2010","September","67185","61887","5298","7.9","7.8"
"BERKSHIRE COUNTY","2010","October","66115","61104","5011","7.6","7.3"
"BERKSHIRE COUNTY","2010","November","66096","60685","5411","8.2","7.5"
"BERKSHIRE COUNTY","2010","December","66364","60868","5496","8.3","7.4"
"BERKSHIRE COUNTY","2010","Annual","67602","61862","5740","8.5","8.1"
"BERKSHIRE COUNTY","2009","January","72516","66635","5881","8.1","7.8"
"BERKSHIRE COUNTY","2009","February","72574","66657","5917","8.2","8.1"
"BERKSHIRE COUNTY","2009","March","72014","66137","5877","8.2","8.1"
"BERKSHIRE COUNTY","2009","April","72090","66840","5250","7.3","7.5"
"BERKSHIRE COUNTY","2009","May","72600","67324","5276","7.3","8.0"
"BERKSHIRE COUNTY","2009","June","75704","69947","5757","7.6","8.4"
"BERKSHIRE COUNTY","2009","July","76248","70548","5700","7.5","8.5"
"BERKSHIRE COUNTY","2009","August","75364","69903","5461","7.2","8.2"
"BERKSHIRE COUNTY","2009","September","72134","66537","5597","7.8","8.4"
"BERKSHIRE COUNTY","2009","October","71843","66504","5339","7.4","8.1"
"BERKSHIRE COUNTY","2009","November","72035","66456","5579","7.7","7.9"
"BERKSHIRE COUNTY","2009","December","71913","65996","5917","8.2","8.2"
"BERKSHIRE COUNTY","2009","Annual","73086","67457","5629","7.7","8.1"
"BERKSHIRE COUNTY","2008","January","72028","67971","4057","5.6","5.2"
"BERKSHIRE COUNTY","2008","February","71714","67838","3876","5.4","5.1"
"BERKSHIRE COUNTY","2008","March","71405","67556","3849","5.4","4.9"
"BERKSHIRE COUNTY","2008","April","70726","67320","3406","4.8","4.4"
"BERKSHIRE COUNTY","2008","May","71661","68199","3462","4.8","4.9"
"BERKSHIRE COUNTY","2008","June","74558","70621","3937","5.3","5.3"
"BERKSHIRE COUNTY","2008","July","76027","72174","3853","5.1","5.5"
"BERKSHIRE COUNTY","2008","August","75398","71777","3621","4.8","5.4"
"BERKSHIRE COUNTY","2008","September","72446","68592","3854","5.3","5.5"
"BERKSHIRE COUNTY","2008","October","72508","68832","3676","5.1","5.4"
"BERKSHIRE COUNTY","2008","November","72597","68419","4178","5.8","5.7"
"BERKSHIRE COUNTY","2008","December","72836","67980","4856","6.7","6.3"
"BERKSHIRE COUNTY","2008","Annual","72825","68940","3885","5.3","5.3"
"BERKSHIRE COUNTY","2007","January","72694","68437","4257","5.9","5.4"
"BERKSHIRE COUNTY","2007","February","72564","68547","4017","5.5","5.1"
"BERKSHIRE COUNTY","2007","March","72131","68384","3747","5.2","4.7"
"BERKSHIRE COUNTY","2007","April","71264","67802","3462","4.9","4.3"
"BERKSHIRE COUNTY","2007","May","72100","69055","3045","4.2","4.3"
"BERKSHIRE COUNTY","2007","June","75203","71793","3410","4.5","4.6"
"BERKSHIRE COUNTY","2007","July","76087","72851","3236","4.3","4.7"
"BERKSHIRE COUNTY","2007","August","75013","72182","2831","3.8","4.3"
"BERKSHIRE COUNTY","2007","September","72109","69173","2936","4.1","4.4"
"BERKSHIRE COUNTY","2007","October","71371","68787","2584","3.6","4.0"
"BERKSHIRE COUNTY","2007","November","71599","68829","2770","3.9","4.0"
"BERKSHIRE COUNTY","2007","December","71709","68615","3094","4.3","4.3"
"BERKSHIRE COUNTY","2007","Annual","72820","69538","3282","4.5","4.5"
"BERKSHIRE COUNTY","2006","January","72094","68147","3947","5.5","5.3"
"BERKSHIRE COUNTY","2006","February","71864","67983","3881","5.4","5.3"
"BERKSHIRE COUNTY","2006","March","71703","68032","3671","5.1","5.0"
"BERKSHIRE COUNTY","2006","April","71537","68339","3198","4.5","4.6"
"BERKSHIRE COUNTY","2006","May","72381","69426","2955","4.1","4.6"
"BERKSHIRE COUNTY","2006","June","75735","72438","3297","4.4","4.8"
"BERKSHIRE COUNTY","2006","July","76696","73582","3114","4.1","5.0"
"BERKSHIRE COUNTY","2006","August","76222","73269","2953","3.9","4.6"
"BERKSHIRE COUNTY","2006","September","72632","69528","3104","4.3","4.7"
"BERKSHIRE COUNTY","2006","October","72949","70261","2688","3.7","4.1"
"BERKSHIRE COUNTY","2006","November","73156","70094","3062","4.2","4.3"
"BERKSHIRE COUNTY","2006","December","73323","70044","3279","4.5","4.3"
"BERKSHIRE COUNTY","2006","Annual","73357","70095","3262","4.4","4.7"
"BERKSHIRE COUNTY","2005","January","72226","68384","3842","5.3","5.5"
"BERKSHIRE COUNTY","2005","February","71813","67951","3862","5.4","5.5"
"BERKSHIRE COUNTY","2005","March","71510","67842","3668","5.1","5.1"
"BERKSHIRE COUNTY","2005","April","71033","67899","3134","4.4","4.6"
"BERKSHIRE COUNTY","2005","May","71865","68907","2958","4.1","4.7"
"BERKSHIRE COUNTY","2005","June","74543","71366","3177","4.3","4.9"
"BERKSHIRE COUNTY","2005","July","75955","72916","3039","4.0","4.9"
"BERKSHIRE COUNTY","2005","August","75498","72780","2718","3.6","4.5"
"BERKSHIRE COUNTY","2005","September","72078","69191","2887","4.0","4.8"
"BERKSHIRE COUNTY","2005","October","71867","69206","2661","3.7","4.3"
"BERKSHIRE COUNTY","2005","November","71705","68721","2984","4.2","4.5"
"BERKSHIRE COUNTY","2005","December","71866","68762","3104","4.3","4.5"
"BERKSHIRE COUNTY","2005","Annual","72664","69494","3170","4.4","4.8"
"BERKSHIRE COUNTY","2004","January","73155","68794","4361","6.0","6.1"
"BERKSHIRE COUNTY","2004","February","72464","68408","4056","5.6","5.8"
"BERKSHIRE COUNTY","2004","March","71990","67946","4044","5.6","5.7"
"BERKSHIRE COUNTY","2004","April","70869","67478","3391","4.8","5.0"
"BERKSHIRE COUNTY","2004","May","71553","68294","3259","4.6","5.0"
"BERKSHIRE COUNTY","2004","June","74326","70724","3602","4.8","5.4"
"BERKSHIRE COUNTY","2004","July","74991","71620","3371","4.5","5.3"
"BERKSHIRE COUNTY","2004","August","74368","71347","3021","4.1","4.8"
"BERKSHIRE COUNTY","2004","September","71543","68636","2907","4.1","4.8"
"BERKSHIRE COUNTY","2004","October","71572","68883","2689","3.8","4.4"
"BERKSHIRE COUNTY","2004","November","71231","68419","2812","3.9","4.5"
"BERKSHIRE COUNTY","2004","December","71327","68301","3026","4.2","4.5"
"BERKSHIRE COUNTY","2004","Annual","72449","69071","3378","4.7","5.1"
"BERKSHIRE COUNTY","2003","January","72578","68344","4234","5.8","6.3"
"BERKSHIRE COUNTY","2003","February","72538","68311","4227","5.8","6.1"
"BERKSHIRE COUNTY","2003","March","71979","67937","4042","5.6","6.0"
"BERKSHIRE COUNTY","2003","April","71690","67975","3715","5.2","5.5"
"BERKSHIRE COUNTY","2003","May","72503","69014","3489","4.8","5.7"
"BERKSHIRE COUNTY","2003","June","74923","71108","3815","5.1","6.2"
"BERKSHIRE COUNTY","2003","July","75649","72082","3567","4.7","6.0"
"BERKSHIRE COUNTY","2003","August","74967","71564","3403","4.5","5.6"
"BERKSHIRE COUNTY","2003","September","72586","69218","3368","4.6","5.7"
"BERKSHIRE COUNTY","2003","October","72164","69009","3155","4.4","5.2"
"BERKSHIRE COUNTY","2003","November","72042","68672","3370","4.7","5.2"
"BERKSHIRE COUNTY","2003","December","72376","68894","3482","4.8","5.1"
"BERKSHIRE COUNTY","2003","Annual","73000","69344","3656","5.0","5.7"
"BERKSHIRE COUNTY","2002","January","71749","68222","3527","4.9","5.6"
"BERKSHIRE COUNTY","2002","February","72031","68598","3433","4.8","5.4"
"BERKSHIRE COUNTY","2002","March","71447","67897","3550","5.0","5.4"
"BERKSHIRE COUNTY","2002","April","71037","67815","3222","4.5","5.0"
"BERKSHIRE COUNTY","2002","May","72151","69126","3025","4.2","4.9"
"BERKSHIRE COUNTY","2002","June","74951","71497","3454","4.6","5.4"
"BERKSHIRE COUNTY","2002","July","75765","72266","3499","4.6","5.4"
"BERKSHIRE COUNTY","2002","August","75326","72134","3192","4.2","5.1"
"BERKSHIRE COUNTY","2002","September","72615","69348","3267","4.5","5.2"
"BERKSHIRE COUNTY","2002","October","72712","69785","2927","4.0","4.9"
"BERKSHIRE COUNTY","2002","November","71976","68764","3212","4.5","5.1"
"BERKSHIRE COUNTY","2002","December","72414","69019","3395","4.7","5.3"
"BERKSHIRE COUNTY","2002","Annual","72848","69539","3309","4.5","5.2"
"BERKSHIRE COUNTY","2001","January","69584","66625","2959","4.3","3.7"
"BERKSHIRE COUNTY","2001","February","69215","66361","2854","4.1","3.5"
"BERKSHIRE COUNTY","2001","March","69275","66355","2920","4.2","3.6"
"BERKSHIRE COUNTY","2001","April","68817","66325","2492","3.6","3.2"
"BERKSHIRE COUNTY","2001","May","69683","67453","2230","3.2","3.3"
"BERKSHIRE COUNTY","2001","June","72346","69815","2531","3.5","3.8"
"BERKSHIRE COUNTY","2001","July","73584","71124","2460","3.3","3.9"
"BERKSHIRE COUNTY","2001","August","72982","70687","2295","3.1","3.9"
"BERKSHIRE COUNTY","2001","September","70813","68487","2326","3.3","4.0"
"BERKSHIRE COUNTY","2001","October","70427","68335","2092","3.0","4.0"
"BERKSHIRE COUNTY","2001","November","70561","68280","2281","3.2","4.2"
"BERKSHIRE COUNTY","2001","December","70798","68191","2607","3.7","4.4"
"BERKSHIRE COUNTY","2001","Annual","70674","68170","2504","3.5","3.8"
"BRISTOL COUNTY","2020","January","304748","290150","14598","4.8","3.5"
"BRISTOL COUNTY","2020","February","304518","290585","13933","4.6","3.3"
"BRISTOL COUNTY","2020","March","300555","286301","14254","4.7","3.6"
"BRISTOL COUNTY","2020","April","280703","220220","60483","21.5","16.7"
"BRISTOL COUNTY","2020","May","295388","239468","55920","18.9","15.6"
"BRISTOL COUNTY","2020","June","305214","255606","49608","16.3","14.5"
"BRISTOL COUNTY","2020","July","304245","260953","43292","14.2","13.0"
"BRISTOL COUNTY","2020","August","303860","269694","34166","11.2","10.3"
"BRISTOL COUNTY","2020","September","301363","269828","31535","10.5","9.8"
"BRISTOL COUNTY","2020","October","300506","275448","25058","8.3","8.1"
"BRISTOL COUNTY","2020","November","299882","276242","23640","7.9","7.6"
"BRISTOL COUNTY","2020","December","298758","274845","23913","8.0","7.4"
"BRISTOL COUNTY","2020","Annual","299978","267445","32533","10.8","9.4"
"BRISTOL COUNTY","2019","January","307010","290765","16245","5.3","4.0"
"BRISTOL COUNTY","2019","February","307581","292282","15299","5.0","3.6"
"BRISTOL COUNTY","2019","March","306148","292266","13882","4.5","3.4"
"BRISTOL COUNTY","2019","April","303588","292948","10640","3.5","2.8"
"BRISTOL COUNTY","2019","May","303806","292891","10915","3.6","2.9"
"BRISTOL COUNTY","2019","June","306268","294170","12098","4.0","3.2"
"BRISTOL COUNTY","2019","July","305681","293100","12581","4.1","3.3"
"BRISTOL COUNTY","2019","August","305708","294056","11652","3.8","3.0"
"BRISTOL COUNTY","2019","September","302530","292050","10480","3.5","2.8"
"BRISTOL COUNTY","2019","October","303460","293624","9836","3.2","2.6"
"BRISTOL COUNTY","2019","November","304519","294849","9670","3.2","2.5"
"BRISTOL COUNTY","2019","December","304267","293668","10599","3.5","2.6"
"BRISTOL COUNTY","2019","Annual","305047","293056","11991","3.9","3.1"
"BRISTOL COUNTY","2018","January","302456","284287","18169","6.0","4.3"
"BRISTOL COUNTY","2018","February","304727","287209","17518","5.7","4.2"
"BRISTOL COUNTY","2018","March","305153","289344","15809","5.2","3.8"
"BRISTOL COUNTY","2018","April","303895","291039","12856","4.2","3.3"
"BRISTOL COUNTY","2018","May","303968","291646","12322","4.1","3.3"
"BRISTOL COUNTY","2018","June","307348","293590","13758","4.5","3.7"
"BRISTOL COUNTY","2018","July","307514","293684","13830","4.5","3.7"
"BRISTOL COUNTY","2018","August","305173","292554","12619","4.1","3.3"
"BRISTOL COUNTY","2018","September","303451","291813","11638","3.8","3.2"
"BRISTOL COUNTY","2018","October","304120","293487","10633","3.5","2.9"
"BRISTOL COUNTY","2018","November","305024","294864","10160","3.3","2.8"
"BRISTOL COUNTY","2018","December","305720","294455","11265","3.7","3.0"
"BRISTOL COUNTY","2018","Annual","304879","291498","13381","4.4","3.4"
"BRISTOL COUNTY","2017","January","297507","279299","18208","6.1","4.5"
"BRISTOL COUNTY","2017","February","298790","280605","18185","6.1","4.4"
"BRISTOL COUNTY","2017","March","299737","283263","16474","5.5","4.0"
"BRISTOL COUNTY","2017","April","297373","283932","13441","4.5","3.6"
"BRISTOL COUNTY","2017","May","297241","283842","13399","4.5","3.7"
"BRISTOL COUNTY","2017","June","300313","285831","14482","4.8","4.0"
"BRISTOL COUNTY","2017","July","301379","286170","15209","5.0","4.1"
"BRISTOL COUNTY","2017","August","300815","286616","14199","4.7","3.8"
"BRISTOL COUNTY","2017","September","298423","284922","13501","4.5","3.7"
"BRISTOL COUNTY","2017","October","297229","285122","12107","4.1","3.3"
"BRISTOL COUNTY","2017","November","299004","286776","12228","4.1","3.3"
"BRISTOL COUNTY","2017","December","299367","286463","12904","4.3","3.4"
"BRISTOL COUNTY","2017","Annual","298931","284403","14528","4.9","3.8"
"BRISTOL COUNTY","2016","January","289765","270784","18981","6.6","4.9"
"BRISTOL COUNTY","2016","February","291017","272268","18749","6.4","4.7"
"BRISTOL COUNTY","2016","March","292704","275141","17563","6.0","4.5"
"BRISTOL COUNTY","2016","April","289568","275150","14418","5.0","3.9"
"BRISTOL COUNTY","2016","May","288141","274756","13385","4.6","3.9"
"BRISTOL COUNTY","2016","June","292264","277646","14618","5.0","4.2"
"BRISTOL COUNTY","2016","July","293229","278060","15169","5.2","4.2"
"BRISTOL COUNTY","2016","August","292261","278308","13953","4.8","3.8"
"BRISTOL COUNTY","2016","September","289711","275858","13853","4.8","3.8"
"BRISTOL COUNTY","2016","October","289547","277187","12360","4.3","3.5"
"BRISTOL COUNTY","2016","November","289720","278022","11698","4.0","3.3"
"BRISTOL COUNTY","2016","December","290347","277615","12732","4.4","3.5"
"BRISTOL COUNTY","2016","Annual","290690","275900","14790","5.1","4.0"
"BRISTOL COUNTY","2015","January","291915","269454","22461","7.7","5.8"
"BRISTOL COUNTY","2015","February","291581","269347","22234","7.6","5.5"
"BRISTOL COUNTY","2015","March","291239","270565","20674","7.1","5.2"
"BRISTOL COUNTY","2015","April","289559","272228","17331","6.0","4.6"
"BRISTOL COUNTY","2015","May","290370","272924","17446","6.0","4.9"
"BRISTOL COUNTY","2015","June","292586","274903","17683","6.0","5.0"
"BRISTOL COUNTY","2015","July","291666","273251","18415","6.3","5.0"
"BRISTOL COUNTY","2015","August","289896","273440","16456","5.7","4.5"
"BRISTOL COUNTY","2015","September","285728","269802","15926","5.6","4.5"
"BRISTOL COUNTY","2015","October","286791","272095","14696","5.1","4.2"
"BRISTOL COUNTY","2015","November","287525","273149","14376","5.0","4.1"
"BRISTOL COUNTY","2015","December","288792","273819","14973","5.2","4.1"
"BRISTOL COUNTY","2015","Annual","289804","272081","17723","6.1","4.8"
"BRISTOL COUNTY","2014","January","286473","260531","25942","9.1","6.7"
"BRISTOL COUNTY","2014","February","288208","261951","26257","9.1","6.7"
"BRISTOL COUNTY","2014","March","290142","264791","25351","8.7","6.4"
"BRISTOL COUNTY","2014","April","286072","265929","20143","7.0","5.5"
"BRISTOL COUNTY","2014","May","287802","267267","20535","7.1","5.7"
"BRISTOL COUNTY","2014","June","290853","269835","21018","7.2","5.9"
"BRISTOL COUNTY","2014","July","291020","268750","22270","7.7","6.1"
"BRISTOL COUNTY","2014","August","290210","269342","20868","7.2","5.7"
"BRISTOL COUNTY","2014","September","287389","267917","19472","6.8","5.5"
"BRISTOL COUNTY","2014","October","289576","271804","17772","6.1","5.0"
"BRISTOL COUNTY","2014","November","290247","272506","17741","6.1","4.9"
"BRISTOL COUNTY","2014","December","290370","272529","17841","6.1","4.8"
"BRISTOL COUNTY","2014","Annual","289031","267763","21268","7.4","5.7"
"BRISTOL COUNTY","2013","January","286855","257876","28979","10.1","7.6"
"BRISTOL COUNTY","2013","February","287258","258486","28772","10.0","7.2"
"BRISTOL COUNTY","2013","March","287803","260458","27345","9.5","6.9"
"BRISTOL COUNTY","2013","April","285805","262002","23803","8.3","6.3"
"BRISTOL COUNTY","2013","May","286502","262406","24096","8.4","6.6"
"BRISTOL COUNTY","2013","June","289894","264467","25427","8.8","7.1"
"BRISTOL COUNTY","2013","July","289165","263407","25758","8.9","7.0"
"BRISTOL COUNTY","2013","August","288474","264160","24314","8.4","6.5"
"BRISTOL COUNTY","2013","September","285009","261716","23293","8.2","6.5"
"BRISTOL COUNTY","2013","October","284084","262328","21756","7.7","6.2"
"BRISTOL COUNTY","2013","November","285345","263877","21468","7.5","5.9"
"BRISTOL COUNTY","2013","December","285365","263716","21649","7.6","5.9"
"BRISTOL COUNTY","2013","Annual","286797","262075","24722","8.6","6.6"
"BRISTOL COUNTY","2012","January","285623","257483","28140","9.9","7.4"
"BRISTOL COUNTY","2012","February","287130","259057","28073","9.8","7.3"
"BRISTOL COUNTY","2012","March","288786","261583","27203","9.4","6.9"
"BRISTOL COUNTY","2012","April","285437","261848","23589","8.3","6.3"
"BRISTOL COUNTY","2012","May","287030","262330","24700","8.6","6.5"
"BRISTOL COUNTY","2012","June","290357","264506","25851","8.9","6.9"
"BRISTOL COUNTY","2012","July","288597","261911","26686","9.2","7.1"
"BRISTOL COUNTY","2012","August","288491","263290","25201","8.7","6.7"
"BRISTOL COUNTY","2012","September","286067","262171","23896","8.4","6.5"
"BRISTOL COUNTY","2012","October","286474","264029","22445","7.8","6.3"
"BRISTOL COUNTY","2012","November","285596","263152","22444","7.9","6.1"
"BRISTOL COUNTY","2012","December","286145","262572","23573","8.2","6.4"
"BRISTOL COUNTY","2012","Annual","287144","261994","25150","8.8","6.7"
"BRISTOL COUNTY","2011","January","286268","254426","31842","11.1","8.3"
"BRISTOL COUNTY","2011","February","287197","255606","31591","11.0","8.0"
"BRISTOL COUNTY","2011","March","287704","257152","30552","10.6","7.6"
"BRISTOL COUNTY","2011","April","285076","258851","26225","9.2","7.0"
"BRISTOL COUNTY","2011","May","285054","258916","26138","9.2","7.1"
"BRISTOL COUNTY","2011","June","287343","260335","27008","9.4","7.5"
"BRISTOL COUNTY","2011","July","286301","259071","27230","9.5","7.5"
"BRISTOL COUNTY","2011","August","286754","260796","25958","9.1","7.0"
"BRISTOL COUNTY","2011","September","284675","259167","25508","9.0","7.1"
"BRISTOL COUNTY","2011","October","285417","261773","23644","8.3","6.6"
"BRISTOL COUNTY","2011","November","285886","262746","23140","8.1","6.4"
"BRISTOL COUNTY","2011","December","285993","262072","23921","8.4","6.5"
"BRISTOL COUNTY","2011","Annual","286139","259243","26896","9.4","7.2"
"BRISTOL COUNTY","2010","January","285956","250884","35072","12.3","9.3"
"BRISTOL COUNTY","2010","February","286751","252160","34591","12.1","9.1"
"BRISTOL COUNTY","2010","March","287380","254082","33298","11.6","8.7"
"BRISTOL COUNTY","2010","April","285379","256373","29006","10.2","8.0"
"BRISTOL COUNTY","2010","May","285973","257259","28714","10.0","7.9"
"BRISTOL COUNTY","2010","June","288092","259622","28470","9.9","8.1"
"BRISTOL COUNTY","2010","July","288011","258751","29260","10.2","8.1"
"BRISTOL COUNTY","2010","August","287872","259880","27992","9.7","7.7"
"BRISTOL COUNTY","2010","September","285049","257814","27235","9.6","7.8"
"BRISTOL COUNTY","2010","October","285577","259628","25949","9.1","7.3"
"BRISTOL COUNTY","2010","November","286760","260011","26749","9.3","7.5"
"BRISTOL COUNTY","2010","December","286622","259632","26990","9.4","7.4"
"BRISTOL COUNTY","2010","Annual","286619","257175","29444","10.3","8.1"
"BRISTOL COUNTY","2009","January","292503","260450","32053","11.0","7.8"
"BRISTOL COUNTY","2009","February","292558","260216","32342","11.1","8.1"
"BRISTOL COUNTY","2009","March","292596","260514","32082","11.0","8.1"
"BRISTOL COUNTY","2009","April","291329","262290","29039","10.0","7.5"
"BRISTOL COUNTY","2009","May","291293","262126","29167","10.0","8.0"
"BRISTOL COUNTY","2009","June","295600","265241","30359","10.3","8.4"
"BRISTOL COUNTY","2009","July","294573","263490","31083","10.6","8.5"
"BRISTOL COUNTY","2009","August","294503","263265","31238","10.6","8.2"
"BRISTOL COUNTY","2009","September","290530","258890","31640","10.9","8.4"
"BRISTOL COUNTY","2009","October","291359","260323","31036","10.7","8.1"
"BRISTOL COUNTY","2009","November","292464","261527","30937","10.6","7.9"
"BRISTOL COUNTY","2009","December","292371","259249","33122","11.3","8.2"
"BRISTOL COUNTY","2009","Annual","292640","261465","31175","10.7","8.1"
"BRISTOL COUNTY","2008","January","290692","268196","22496","7.7","5.2"
"BRISTOL COUNTY","2008","February","288530","267321","21209","7.4","5.1"
"BRISTOL COUNTY","2008","March","289944","268847","21097","7.3","4.9"
"BRISTOL COUNTY","2008","April","289058","270297","18761","6.5","4.4"
"BRISTOL COUNTY","2008","May","287806","270141","17665","6.1","4.9"
"BRISTOL COUNTY","2008","June","292161","272695","19466","6.7","5.3"
"BRISTOL COUNTY","2008","July","291432","270320","21112","7.2","5.5"
"BRISTOL COUNTY","2008","August","291777","270646","21131","7.2","5.4"
"BRISTOL COUNTY","2008","September","289421","267799","21622","7.5","5.5"
"BRISTOL COUNTY","2008","October","291711","269918","21793","7.5","5.4"
"BRISTOL COUNTY","2008","November","291973","269633","22340","7.7","5.7"
"BRISTOL COUNTY","2008","December","293622","267531","26091","8.9","6.3"
"BRISTOL COUNTY","2008","Annual","290677","269445","21232","7.3","5.3"
"BRISTOL COUNTY","2007","January","292924","270684","22240","7.6","5.4"
"BRISTOL COUNTY","2007","February","291359","270568","20791","7.1","5.1"
"BRISTOL COUNTY","2007","March","291817","272141","19676","6.7","4.7"
"BRISTOL COUNTY","2007","April","289121","272023","17098","5.9","4.3"
"BRISTOL COUNTY","2007","May","287556","272883","14673","5.1","4.3"
"BRISTOL COUNTY","2007","June","291598","275568","16030","5.5","4.6"
"BRISTOL COUNTY","2007","July","291308","273750","17558","6.0","4.7"
"BRISTOL COUNTY","2007","August","290404","274230","16174","5.6","4.3"
"BRISTOL COUNTY","2007","September","287653","271976","15677","5.4","4.4"
"BRISTOL COUNTY","2007","October","287584","273655","13929","4.8","4.0"
"BRISTOL COUNTY","2007","November","290131","274858","15273","5.3","4.0"
"BRISTOL COUNTY","2007","December","290573","272833","17740","6.1","4.3"
"BRISTOL COUNTY","2007","Annual","290169","272931","17238","5.9","4.5"
"BRISTOL COUNTY","2006","January","288996","267034","21962","7.6","5.3"
"BRISTOL COUNTY","2006","February","288882","267631","21251","7.4","5.3"
"BRISTOL COUNTY","2006","March","290278","269502","20776","7.2","5.0"
"BRISTOL COUNTY","2006","April","288638","270782","17856","6.2","4.6"
"BRISTOL COUNTY","2006","May","288273","271927","16346","5.7","4.6"
"BRISTOL COUNTY","2006","June","292435","275365","17070","5.8","4.8"
"BRISTOL COUNTY","2006","July","290897","273208","17689","6.1","5.0"
"BRISTOL COUNTY","2006","August","290675","274194","16481","5.7","4.6"
"BRISTOL COUNTY","2006","September","289435","272184","17251","6.0","4.7"
"BRISTOL COUNTY","2006","October","290380","275687","14693","5.1","4.1"
"BRISTOL COUNTY","2006","November","291835","276450","15385","5.3","4.3"
"BRISTOL COUNTY","2006","December","293035","275882","17153","5.9","4.3"
"BRISTOL COUNTY","2006","Annual","290313","272487","17826","6.1","4.7"
"BRISTOL COUNTY","2005","January","287974","266586","21388","7.4","5.5"
"BRISTOL COUNTY","2005","February","287116","266679","20437","7.1","5.5"
"BRISTOL COUNTY","2005","March","287743","268047","19696","6.8","5.1"
"BRISTOL COUNTY","2005","April","285730","269325","16405","5.7","4.6"
"BRISTOL COUNTY","2005","May","285485","270463","15022","5.3","4.7"
"BRISTOL COUNTY","2005","June","290417","273953","16464","5.7","4.9"
"BRISTOL COUNTY","2005","July","288500","271633","16867","5.8","4.9"
"BRISTOL COUNTY","2005","August","288508","272804","15704","5.4","4.5"
"BRISTOL COUNTY","2005","September","287033","269637","17396","6.1","4.8"
"BRISTOL COUNTY","2005","October","287589","272767","14822","5.2","4.3"
"BRISTOL COUNTY","2005","November","288567","273305","15262","5.3","4.5"
"BRISTOL COUNTY","2005","December","289289","272168","17121","5.9","4.5"
"BRISTOL COUNTY","2005","Annual","287829","270614","17215","6.0","4.8"
"BRISTOL COUNTY","2004","January","291184","267471","23713","8.1","6.1"
"BRISTOL COUNTY","2004","February","288448","267456","20992","7.3","5.8"
"BRISTOL COUNTY","2004","March","288652","268226","20426","7.1","5.7"
"BRISTOL COUNTY","2004","April","285927","268750","17177","6.0","5.0"
"BRISTOL COUNTY","2004","May","285627","269189","16438","5.8","5.0"
"BRISTOL COUNTY","2004","June","290139","272265","17874","6.2","5.4"
"BRISTOL COUNTY","2004","July","287753","269712","18041","6.3","5.3"
"BRISTOL COUNTY","2004","August","286709","270942","15767","5.5","4.8"
"BRISTOL COUNTY","2004","September","284037","267926","16111","5.7","4.8"
"BRISTOL COUNTY","2004","October","285413","271051","14362","5.0","4.4"
"BRISTOL COUNTY","2004","November","287063","272284","14779","5.1","4.5"
"BRISTOL COUNTY","2004","December","287047","271095","15952","5.6","4.5"
"BRISTOL COUNTY","2004","Annual","287333","269697","17636","6.1","5.1"
"BRISTOL COUNTY","2003","January","288230","265426","22804","7.9","6.3"
"BRISTOL COUNTY","2003","February","287093","266130","20963","7.3","6.1"
"BRISTOL COUNTY","2003","March","287275","266999","20276","7.1","6.0"
"BRISTOL COUNTY","2003","April","286206","267849","18357","6.4","5.5"
"BRISTOL COUNTY","2003","May","285442","268188","17254","6.0","5.7"
"BRISTOL COUNTY","2003","June","290698","271229","19469","6.7","6.2"
"BRISTOL COUNTY","2003","July","288413","268740","19673","6.8","6.0"
"BRISTOL COUNTY","2003","August","287861","270348","17513","6.1","5.6"
"BRISTOL COUNTY","2003","September","285190","267981","17209","6.0","5.7"
"BRISTOL COUNTY","2003","October","286644","270697","15947","5.6","5.2"
"BRISTOL COUNTY","2003","November","289233","272528","16705","5.8","5.2"
"BRISTOL COUNTY","2003","December","289675","271462","18213","6.3","5.1"
"BRISTOL COUNTY","2003","Annual","287664","268965","18699","6.5","5.7"
"BRISTOL COUNTY","2002","January","282886","263046","19840","7.0","5.6"
"BRISTOL COUNTY","2002","February","284424","265734","18690","6.6","5.4"
"BRISTOL COUNTY","2002","March","285110","266838","18272","6.4","5.4"
"BRISTOL COUNTY","2002","April","284032","267511","16521","5.8","5.0"
"BRISTOL COUNTY","2002","May","284573","268601","15972","5.6","4.9"
"BRISTOL COUNTY","2002","June","288435","270903","17532","6.1","5.4"
"BRISTOL COUNTY","2002","July","287327","269039","18288","6.4","5.4"
"BRISTOL COUNTY","2002","August","289598","271283","18315","6.3","5.1"
"BRISTOL COUNTY","2002","September","285527","268976","16551","5.8","5.2"
"BRISTOL COUNTY","2002","October","286849","270891","15958","5.6","4.9"
"BRISTOL COUNTY","2002","November","287416","270774","16642","5.8","5.1"
"BRISTOL COUNTY","2002","December","287276","270031","17245","6.0","5.3"
"BRISTOL COUNTY","2002","Annual","286122","268636","17486","6.1","5.2"
"BRISTOL COUNTY","2001","January","277187","261275","15912","5.7","3.7"
"BRISTOL COUNTY","2001","February","276671","261828","14843","5.4","3.5"
"BRISTOL COUNTY","2001","March","277931","263051","14880","5.4","3.6"
"BRISTOL COUNTY","2001","April","276676","263959","12717","4.6","3.2"
"BRISTOL COUNTY","2001","May","276192","264369","11823","4.3","3.3"
"BRISTOL COUNTY","2001","June","280763","267081","13682","4.9","3.8"
"BRISTOL COUNTY","2001","July","278799","264949","13850","5.0","3.9"
"BRISTOL COUNTY","2001","August","278122","265741","12381","4.5","3.9"
"BRISTOL COUNTY","2001","September","276323","264177","12146","4.4","4.0"
"BRISTOL COUNTY","2001","October","277556","266106","11450","4.1","4.0"
"BRISTOL COUNTY","2001","November","279502","267108","12394","4.4","4.2"
"BRISTOL COUNTY","2001","December","280280","267154","13126","4.7","4.4"
"BRISTOL COUNTY","2001","Annual","278000","264733","13267","4.8","3.8"
"DUKES COUNTY","2020","January","8480","7836","644","7.6","3.5"
"DUKES COUNTY","2020","February","8369","7755","614","7.3","3.3"
"DUKES COUNTY","2020","March","8269","7674","595","7.2","3.6"
"DUKES COUNTY","2020","April","8512","6490","2022","23.8","16.7"
"DUKES COUNTY","2020","May","9305","7825","1480","15.9","15.6"
"DUKES COUNTY","2020","June","11259","9988","1271","11.3","14.5"
"DUKES COUNTY","2020","July","11982","10909","1073","9.0","13.0"
"DUKES COUNTY","2020","August","11756","10985","771","6.6","10.3"
"DUKES COUNTY","2020","September","10028","9328","700","7.0","9.8"
"DUKES COUNTY","2020","October","9208","8595","613","6.7","8.1"
"DUKES COUNTY","2020","November","8564","7808","756","8.8","7.6"
"DUKES COUNTY","2020","December","8770","7984","786","9.0","7.4"
"DUKES COUNTY","2020","Annual","9542","8598","944","9.9","9.4"
"DUKES COUNTY","2019","January","8610","7849","761","8.8","4.0"
"DUKES COUNTY","2019","February","8285","7548","737","8.9","3.6"
"DUKES COUNTY","2019","March","8219","7600","619","7.5","3.4"
"DUKES COUNTY","2019","April","8587","8152","435","5.1","2.8"
"DUKES COUNTY","2019","May","9509","9168","341","3.6","2.9"
"DUKES COUNTY","2019","June","11193","10878","315","2.8","3.2"
"DUKES COUNTY","2019","July","12665","12385","280","2.2","3.3"
"DUKES COUNTY","2019","August","12458","12215","243","2.0","3.0"
"DUKES COUNTY","2019","September","10352","10111","241","2.3","2.8"
"DUKES COUNTY","2019","October","9288","9044","244","2.6","2.6"
"DUKES COUNTY","2019","November","8561","8196","365","4.3","2.5"
"DUKES COUNTY","2019","December","8721","8285","436","5.0","2.6"
"DUKES COUNTY","2019","Annual","9704","9286","418","4.3","3.1"
"DUKES COUNTY","2018","January","8432","7643","789","9.4","4.3"
"DUKES COUNTY","2018","February","8342","7565","777","9.3","4.2"
"DUKES COUNTY","2018","March","8347","7664","683","8.2","3.8"
"DUKES COUNTY","2018","April","8656","8162","494","5.7","3.3"
"DUKES COUNTY","2018","May","9581","9163","418","4.4","3.3"
"DUKES COUNTY","2018","June","11436","11076","360","3.1","3.7"
"DUKES COUNTY","2018","July","12789","12474","315","2.5","3.7"
"DUKES COUNTY","2018","August","12577","12310","267","2.1","3.3"
"DUKES COUNTY","2018","September","10465","10193","272","2.6","3.2"
"DUKES COUNTY","2018","October","9452","9168","284","3.0","2.9"
"DUKES COUNTY","2018","November","8748","8345","403","4.6","2.8"
"DUKES COUNTY","2018","December","8712","8209","503","5.8","3.0"
"DUKES COUNTY","2018","Annual","9795","9331","464","4.7","3.4"
"DUKES COUNTY","2017","January","8178","7421","757","9.3","4.5"
"DUKES COUNTY","2017","February","8113","7374","739","9.1","4.4"
"DUKES COUNTY","2017","March","8208","7553","655","8.0","4.0"
"DUKES COUNTY","2017","April","8398","7920","478","5.7","3.6"
"DUKES COUNTY","2017","May","9151","8747","404","4.4","3.7"
"DUKES COUNTY","2017","June","11332","10961","371","3.3","4.0"
"DUKES COUNTY","2017","July","12594","12255","339","2.7","4.1"
"DUKES COUNTY","2017","August","12619","12296","323","2.6","3.8"
"DUKES COUNTY","2017","September","10515","10186","329","3.1","3.7"
"DUKES COUNTY","2017","October","9265","8932","333","3.6","3.3"
"DUKES COUNTY","2017","November","8661","8182","479","5.5","3.3"
"DUKES COUNTY","2017","December","8678","8111","567","6.5","3.4"
"DUKES COUNTY","2017","Annual","9643","9162","481","5.0","3.8"
"DUKES COUNTY","2016","January","8164","7346","818","10.0","4.9"
"DUKES COUNTY","2016","February","8037","7218","819","10.2","4.7"
"DUKES COUNTY","2016","March","8153","7403","750","9.2","4.5"
"DUKES COUNTY","2016","April","8313","7788","525","6.3","3.9"
"DUKES COUNTY","2016","May","8944","8523","421","4.7","3.9"
"DUKES COUNTY","2016","June","10723","10344","379","3.5","4.2"
"DUKES COUNTY","2016","July","12130","11777","353","2.9","4.2"
"DUKES COUNTY","2016","August","12050","11732","318","2.6","3.8"
"DUKES COUNTY","2016","September","10104","9776","328","3.2","3.8"
"DUKES COUNTY","2016","October","8956","8637","319","3.6","3.5"
"DUKES COUNTY","2016","November","8345","7904","441","5.3","3.3"
"DUKES COUNTY","2016","December","8359","7836","523","6.3","3.5"
"DUKES COUNTY","2016","Annual","9357","8857","500","5.3","4.0"
"DUKES COUNTY","2015","January","8336","7338","998","12.0","5.8"
"DUKES COUNTY","2015","February","8252","7283","969","11.7","5.5"
"DUKES COUNTY","2015","March","8131","7247","884","10.9","5.2"
"DUKES COUNTY","2015","April","8477","7857","620","7.3","4.6"
"DUKES COUNTY","2015","May","9358","8795","563","6.0","4.9"
"DUKES COUNTY","2015","June","10957","10461","496","4.5","5.0"
"DUKES COUNTY","2015","July","12135","11671","464","3.8","5.0"
"DUKES COUNTY","2015","August","12044","11637","407","3.4","4.5"
"DUKES COUNTY","2015","September","10103","9694","409","4.0","4.5"
"DUKES COUNTY","2015","October","8977","8567","410","4.6","4.2"
"DUKES COUNTY","2015","November","8441","7880","561","6.6","4.1"
"DUKES COUNTY","2015","December","8340","7708","632","7.6","4.1"
"DUKES COUNTY","2015","Annual","9463","8845","618","6.5","4.8"
"DUKES COUNTY","2014","January","8346","7234","1112","13.3","6.7"
"DUKES COUNTY","2014","February","8275","7117","1158","14.0","6.7"
"DUKES COUNTY","2014","March","8248","7161","1087","13.2","6.4"
"DUKES COUNTY","2014","April","8564","7800","764","8.9","5.5"
"DUKES COUNTY","2014","May","9363","8712","651","7.0","5.7"
"DUKES COUNTY","2014","June","10883","10283","600","5.5","5.9"
"DUKES COUNTY","2014","July","11947","11359","588","4.9","6.1"
"DUKES COUNTY","2014","August","11792","11274","518","4.4","5.7"
"DUKES COUNTY","2014","September","10065","9547","518","5.1","5.5"
"DUKES COUNTY","2014","October","9211","8683","528","5.7","5.0"
"DUKES COUNTY","2014","November","8546","7841","705","8.2","4.9"
"DUKES COUNTY","2014","December","8518","7752","766","9.0","4.8"
"DUKES COUNTY","2014","Annual","9480","8730","750","7.9","5.7"
"DUKES COUNTY","2013","January","8335","7122","1213","14.6","7.6"
"DUKES COUNTY","2013","February","8267","7039","1228","14.9","7.2"
"DUKES COUNTY","2013","March","8136","7007","1129","13.9","6.9"
"DUKES COUNTY","2013","April","8636","7768","868","10.1","6.3"
"DUKES COUNTY","2013","May","9363","8595","768","8.2","6.6"
"DUKES COUNTY","2013","June","10908","10184","724","6.6","7.1"
"DUKES COUNTY","2013","July","11979","11288","691","5.8","7.0"
"DUKES COUNTY","2013","August","11637","11011","626","5.4","6.5"
"DUKES COUNTY","2013","September","10019","9371","648","6.5","6.5"
"DUKES COUNTY","2013","October","8901","8273","628","7.1","6.2"
"DUKES COUNTY","2013","November","8424","7614","810","9.6","5.9"
"DUKES COUNTY","2013","December","8341","7490","851","10.2","5.9"
"DUKES COUNTY","2013","Annual","9413","8564","849","9.0","6.6"
"DUKES COUNTY","2012","January","8100","6996","1104","13.6","7.4"
"DUKES COUNTY","2012","February","8177","7028","1149","14.1","7.3"
"DUKES COUNTY","2012","March","8126","7029","1097","13.5","6.9"
"DUKES COUNTY","2012","April","8571","7724","847","9.9","6.3"
"DUKES COUNTY","2012","May","9158","8383","775","8.5","6.5"
"DUKES COUNTY","2012","June","10855","10160","695","6.4","6.9"
"DUKES COUNTY","2012","July","11837","11163","674","5.7","7.1"
"DUKES COUNTY","2012","August","11596","10977","619","5.3","6.7"
"DUKES COUNTY","2012","September","10031","9405","626","6.2","6.5"
"DUKES COUNTY","2012","October","9015","8373","642","7.1","6.3"
"DUKES COUNTY","2012","November","8621","7783","838","9.7","6.1"
"DUKES COUNTY","2012","December","8539","7603","936","11.0","6.4"
"DUKES COUNTY","2012","Annual","9386","8552","834","8.9","6.7"
"DUKES COUNTY","2011","January","8017","6819","1198","14.9","8.3"
"DUKES COUNTY","2011","February","8005","6800","1205","15.1","8.0"
"DUKES COUNTY","2011","March","7999","6863","1136","14.2","7.6"
"DUKES COUNTY","2011","April","8404","7542","862","10.3","7.0"
"DUKES COUNTY","2011","May","8979","8201","778","8.7","7.1"
"DUKES COUNTY","2011","June","10597","9880","717","6.8","7.5"
"DUKES COUNTY","2011","July","11655","10984","671","5.8","7.5"
"DUKES COUNTY","2011","August","11581","10938","643","5.6","7.0"
"DUKES COUNTY","2011","September","9786","9136","650","6.6","7.1"
"DUKES COUNTY","2011","October","8782","8132","650","7.4","6.6"
"DUKES COUNTY","2011","November","8233","7404","829","10.1","6.4"
"DUKES COUNTY","2011","December","8315","7391","924","11.1","6.5"
"DUKES COUNTY","2011","Annual","9196","8341","855","9.3","7.2"
"DUKES COUNTY","2010","January","7919","6734","1185","15.0","9.3"
"DUKES COUNTY","2010","February","7852","6667","1185","15.1","9.1"
"DUKES COUNTY","2010","March","7905","6791","1114","14.1","8.7"
"DUKES COUNTY","2010","April","8497","7605","892","10.5","8.0"
"DUKES COUNTY","2010","May","8984","8200","784","8.7","7.9"
"DUKES COUNTY","2010","June","10498","9802","696","6.6","8.1"
"DUKES COUNTY","2010","July","11514","10838","676","5.9","8.1"
"DUKES COUNTY","2010","August","11378","10735","643","5.7","7.7"
"DUKES COUNTY","2010","September","9698","9041","657","6.8","7.8"
"DUKES COUNTY","2010","October","8648","7974","674","7.8","7.3"
"DUKES COUNTY","2010","November","8184","7289","895","10.9","7.5"
"DUKES COUNTY","2010","December","8146","7195","951","11.7","7.4"
"DUKES COUNTY","2010","Annual","9102","8239","863","9.5","8.1"
"DUKES COUNTY","2009","January","9158","8209","949","10.4","7.8"
"DUKES COUNTY","2009","February","9089","8136","953","10.5","8.1"
"DUKES COUNTY","2009","March","9109","8229","880","9.7","8.1"
"DUKES COUNTY","2009","April","9848","9154","694","7.0","7.5"
"DUKES COUNTY","2009","May","10971","10365","606","5.5","8.0"
"DUKES COUNTY","2009","June","13776","13191","585","4.2","8.4"
"DUKES COUNTY","2009","July","15239","14693","546","3.6","8.5"
"DUKES COUNTY","2009","August","14997","14472","525","3.5","8.2"
"DUKES COUNTY","2009","September","12657","12076","581","4.6","8.4"
"DUKES COUNTY","2009","October","10966","10361","605","5.5","8.1"
"DUKES COUNTY","2009","November","10141","9340","801","7.9","7.9"
"DUKES COUNTY","2009","December","10050","9100","950","9.5","8.2"
"DUKES COUNTY","2009","Annual","11334","10611","723","6.4","8.1"
"DUKES COUNTY","2008","January","9330","8702","628","6.7","5.2"
"DUKES COUNTY","2008","February","9157","8572","585","6.4","5.1"
"DUKES COUNTY","2008","March","9184","8627","557","6.1","4.9"
"DUKES COUNTY","2008","April","9739","9303","436","4.5","4.4"
"DUKES COUNTY","2008","May","10963","10580","383","3.5","4.9"
"DUKES COUNTY","2008","June","13521","13113","408","3.0","5.3"
"DUKES COUNTY","2008","July","15149","14797","352","2.3","5.5"
"DUKES COUNTY","2008","August","14879","14541","338","2.3","5.4"
"DUKES COUNTY","2008","September","12219","11845","374","3.1","5.5"
"DUKES COUNTY","2008","October","10681","10282","399","3.7","5.4"
"DUKES COUNTY","2008","November","9775","9177","598","6.1","5.7"
"DUKES COUNTY","2008","December","9606","8899","707","7.4","6.3"
"DUKES COUNTY","2008","Annual","11183","10703","480","4.3","5.3"
"DUKES COUNTY","2007","January","9244","8601","643","7.0","5.4"
"DUKES COUNTY","2007","February","9125","8544","581","6.4","5.1"
"DUKES COUNTY","2007","March","9177","8662","515","5.6","4.7"
"DUKES COUNTY","2007","April","9731","9306","425","4.4","4.3"
"DUKES COUNTY","2007","May","10803","10445","358","3.3","4.3"
"DUKES COUNTY","2007","June","13607","13254","353","2.6","4.6"
"DUKES COUNTY","2007","July","14927","14620","307","2.1","4.7"
"DUKES COUNTY","2007","August","14914","14657","257","1.7","4.3"
"DUKES COUNTY","2007","September","12212","11928","284","2.3","4.4"
"DUKES COUNTY","2007","October","10712","10444","268","2.5","4.0"
"DUKES COUNTY","2007","November","9623","9245","378","3.9","4.0"
"DUKES COUNTY","2007","December","9456","9003","453","4.8","4.3"
"DUKES COUNTY","2007","Annual","11128","10726","402","3.6","4.5"
"DUKES COUNTY","2006","January","9081","8418","663","7.3","5.3"
"DUKES COUNTY","2006","February","8951","8325","626","7.0","5.3"
"DUKES COUNTY","2006","March","8930","8354","576","6.5","5.0"
"DUKES COUNTY","2006","April","9577","9086","491","5.1","4.6"
"DUKES COUNTY","2006","May","10659","10255","404","3.8","4.6"
"DUKES COUNTY","2006","June","12835","12462","373","2.9","4.8"
"DUKES COUNTY","2006","July","15075","14756","319","2.1","5.0"
"DUKES COUNTY","2006","August","14921","14623","298","2.0","4.6"
"DUKES COUNTY","2006","September","12277","11960","317","2.6","4.7"
"DUKES COUNTY","2006","October","10960","10659","301","2.7","4.1"
"DUKES COUNTY","2006","November","9797","9359","438","4.5","4.3"
"DUKES COUNTY","2006","December","9564","9069","495","5.2","4.3"
"DUKES COUNTY","2006","Annual","11053","10611","442","4.0","4.7"
"DUKES COUNTY","2005","January","8856","8224","632","7.1","5.5"
"DUKES COUNTY","2005","February","8888","8268","620","7.0","5.5"
"DUKES COUNTY","2005","March","8824","8251","573","6.5","5.1"
"DUKES COUNTY","2005","April","9598","9162","436","4.5","4.6"
"DUKES COUNTY","2005","May","10609","10258","351","3.3","4.7"
"DUKES COUNTY","2005","June","13106","12761","345","2.6","4.9"
"DUKES COUNTY","2005","July","14999","14683","316","2.1","4.9"
"DUKES COUNTY","2005","August","14838","14547","291","2.0","4.5"
"DUKES COUNTY","2005","September","12536","12224","312","2.5","4.8"
"DUKES COUNTY","2005","October","10540","10224","316","3.0","4.3"
"DUKES COUNTY","2005","November","9583","9116","467","4.9","4.5"
"DUKES COUNTY","2005","December","9336","8817","519","5.6","4.5"
"DUKES COUNTY","2005","Annual","10977","10545","432","3.9","4.8"
"DUKES COUNTY","2004","January","9186","8481","705","7.7","6.1"
"DUKES COUNTY","2004","February","8937","8288","649","7.3","5.8"
"DUKES COUNTY","2004","March","8927","8283","644","7.2","5.7"
"DUKES COUNTY","2004","April","9774","9309","465","4.8","5.0"
"DUKES COUNTY","2004","May","10890","10499","391","3.6","5.0"
"DUKES COUNTY","2004","June","13475","13089","386","2.9","5.4"
"DUKES COUNTY","2004","July","15422","15090","332","2.2","5.3"
"DUKES COUNTY","2004","August","15119","14817","302","2.0","4.8"
"DUKES COUNTY","2004","September","12658","12380","278","2.2","4.8"
"DUKES COUNTY","2004","October","10841","10546","295","2.7","4.4"
"DUKES COUNTY","2004","November","9599","9170","429","4.5","4.5"
"DUKES COUNTY","2004","December","9400","8943","457","4.9","4.5"
"DUKES COUNTY","2004","Annual","11185","10741","444","4.0","5.1"
"DUKES COUNTY","2003","January","8873","8196","677","7.6","6.3"
"DUKES COUNTY","2003","February","8774","8142","632","7.2","6.1"
"DUKES COUNTY","2003","March","8782","8174","608","6.9","6.0"
"DUKES COUNTY","2003","April","9323","8828","495","5.3","5.5"
"DUKES COUNTY","2003","May","10856","10453","403","3.7","5.7"
"DUKES COUNTY","2003","June","13689","13280","409","3.0","6.2"
"DUKES COUNTY","2003","July","15177","14827","350","2.3","6.0"
"DUKES COUNTY","2003","August","14966","14637","329","2.2","5.6"
"DUKES COUNTY","2003","September","12593","12272","321","2.5","5.7"
"DUKES COUNTY","2003","October","11095","10770","325","2.9","5.2"
"DUKES COUNTY","2003","November","9811","9313","498","5.1","5.2"
"DUKES COUNTY","2003","December","9640","9118","522","5.4","5.1"
"DUKES COUNTY","2003","Annual","11132","10668","464","4.2","5.7"
"DUKES COUNTY","2002","January","8518","7935","583","6.8","5.6"
"DUKES COUNTY","2002","February","8464","7905","559","6.6","5.4"
"DUKES COUNTY","2002","March","8651","8089","562","6.5","5.4"
"DUKES COUNTY","2002","April","9172","8736","436","4.8","5.0"
"DUKES COUNTY","2002","May","10252","9908","344","3.4","4.9"
"DUKES COUNTY","2002","June","12732","12377","355","2.8","5.4"
"DUKES COUNTY","2002","July","14312","14008","304","2.1","5.4"
"DUKES COUNTY","2002","August","14246","13988","258","1.8","5.1"
"DUKES COUNTY","2002","September","12046","11765","281","2.3","5.2"
"DUKES COUNTY","2002","October","10668","10411","257","2.4","4.9"
"DUKES COUNTY","2002","November","9570","9133","437","4.6","5.1"
"DUKES COUNTY","2002","December","9239","8749","490","5.3","5.3"
"DUKES COUNTY","2002","Annual","10656","10250","406","3.8","5.2"
"DUKES COUNTY","2001","January","8194","7724","470","5.7","3.7"
"DUKES COUNTY","2001","February","8083","7648","435","5.4","3.5"
"DUKES COUNTY","2001","March","8341","7919","422","5.1","3.6"
"DUKES COUNTY","2001","April","8737","8427","310","3.5","3.2"
"DUKES COUNTY","2001","May","9953","9707","246","2.5","3.3"
"DUKES COUNTY","2001","June","12360","12139","221","1.8","3.8"
"DUKES COUNTY","2001","July","13474","13273","201","1.5","3.9"
"DUKES COUNTY","2001","August","13171","13003","168","1.3","3.9"
"DUKES COUNTY","2001","September","11292","11109","183","1.6","4.0"
"DUKES COUNTY","2001","October","9779","9596","183","1.9","4.0"
"DUKES COUNTY","2001","November","8877","8540","337","3.8","4.2"
"DUKES COUNTY","2001","December","8868","8471","397","4.5","4.4"
"DUKES COUNTY","2001","Annual","10094","9796","298","3.0","3.8"
"ESSEX COUNTY","2020","January","429253","414160","15093","3.5","3.5"
"ESSEX COUNTY","2020","February","428814","414590","14224","3.3","3.3"
"ESSEX COUNTY","2020","March","423161","407794","15367","3.6","3.6"
"ESSEX COUNTY","2020","April","392380","319364","73016","18.6","16.7"
"ESSEX COUNTY","2020","May","415945","343417","72528","17.4","15.6"
"ESSEX COUNTY","2020","June","431840","361662","70178","16.3","14.5"
"ESSEX COUNTY","2020","July","433526","371110","62416","14.4","13.0"
"ESSEX COUNTY","2020","August","432530","382749","49781","11.5","10.3"
"ESSEX COUNTY","2020","September","427043","380179","46864","11.0","9.8"
"ESSEX COUNTY","2020","October","426813","388331","38482","9.0","8.1"
"ESSEX COUNTY","2020","November","424900","389335","35565","8.4","7.6"
"ESSEX COUNTY","2020","December","424004","389536","34468","8.1","7.4"
"ESSEX COUNTY","2020","Annual","424185","380186","43999","10.4","9.4"
"ESSEX COUNTY","2019","January","432381","415023","17358","4.0","4.0"
"ESSEX COUNTY","2019","February","431995","416164","15831","3.7","3.6"
"ESSEX COUNTY","2019","March","432298","417437","14861","3.4","3.4"
"ESSEX COUNTY","2019","April","429770","417415","12355","2.9","2.8"
"ESSEX COUNTY","2019","May","429597","416541","13056","3.0","2.9"
"ESSEX COUNTY","2019","June","435139","420783","14356","3.3","3.2"
"ESSEX COUNTY","2019","July","435551","420952","14599","3.4","3.3"
"ESSEX COUNTY","2019","August","434700","421437","13263","3.1","3.0"
"ESSEX COUNTY","2019","September","428174","415581","12593","2.9","2.8"
"ESSEX COUNTY","2019","October","430033","418405","11628","2.7","2.6"
"ESSEX COUNTY","2019","November","429935","418717","11218","2.6","2.5"
"ESSEX COUNTY","2019","December","429383","417895","11488","2.7","2.6"
"ESSEX COUNTY","2019","Annual","431580","418029","13551","3.1","3.1"
"ESSEX COUNTY","2018","January","424738","406627","18111","4.3","4.3"
"ESSEX COUNTY","2018","February","428273","410371","17902","4.2","4.2"
"ESSEX COUNTY","2018","March","429509","412849","16660","3.9","3.8"
"ESSEX COUNTY","2018","April","428466","413834","14632","3.4","3.3"
"ESSEX COUNTY","2018","May","430004","415325","14679","3.4","3.3"
"ESSEX COUNTY","2018","June","435331","418549","16782","3.9","3.7"
"ESSEX COUNTY","2018","July","435283","418952","16331","3.8","3.7"
"ESSEX COUNTY","2018","August","431842","416992","14850","3.4","3.3"
"ESSEX COUNTY","2018","September","427497","413204","14293","3.3","3.2"
"ESSEX COUNTY","2018","October","430159","417168","12991","3.0","2.9"
"ESSEX COUNTY","2018","November","430575","418313","12262","2.8","2.8"
"ESSEX COUNTY","2018","December","431160","417909","13251","3.1","3.0"
"ESSEX COUNTY","2018","Annual","430237","415008","15229","3.5","3.4"
"ESSEX COUNTY","2017","January","417842","399042","18800","4.5","4.5"
"ESSEX COUNTY","2017","February","418935","400443","18492","4.4","4.4"
"ESSEX COUNTY","2017","March","421518","404310","17208","4.1","4.0"
"ESSEX COUNTY","2017","April","420308","404831","15477","3.7","3.6"
"ESSEX COUNTY","2017","May","419301","403299","16002","3.8","3.7"
"ESSEX COUNTY","2017","June","425210","407846","17364","4.1","4.0"
"ESSEX COUNTY","2017","July","426219","408803","17416","4.1","4.1"
"ESSEX COUNTY","2017","August","425064","408606","16458","3.9","3.8"
"ESSEX COUNTY","2017","September","420571","404594","15977","3.8","3.7"
"ESSEX COUNTY","2017","October","420645","406223","14422","3.4","3.3"
"ESSEX COUNTY","2017","November","422793","408418","14375","3.4","3.3"
"ESSEX COUNTY","2017","December","423620","408833","14787","3.5","3.4"
"ESSEX COUNTY","2017","Annual","421835","405437","16398","3.9","3.8"
"ESSEX COUNTY","2016","January","405838","385477","20361","5.0","4.9"
"ESSEX COUNTY","2016","February","408396","388807","19589","4.8","4.7"
"ESSEX COUNTY","2016","March","410500","391586","18914","4.6","4.5"
"ESSEX COUNTY","2016","April","409095","392430","16665","4.1","3.9"
"ESSEX COUNTY","2016","May","408016","391745","16271","4.0","3.9"
"ESSEX COUNTY","2016","June","413687","395974","17713","4.3","4.2"
"ESSEX COUNTY","2016","July","415360","397871","17489","4.2","4.2"
"ESSEX COUNTY","2016","August","414146","398022","16124","3.9","3.8"
"ESSEX COUNTY","2016","September","408944","392577","16367","4.0","3.8"
"ESSEX COUNTY","2016","October","410326","395563","14763","3.6","3.5"
"ESSEX COUNTY","2016","November","410949","396780","14169","3.4","3.3"
"ESSEX COUNTY","2016","December","411389","396568","14821","3.6","3.5"
"ESSEX COUNTY","2016","Annual","410554","393617","16937","4.1","4.0"
"ESSEX COUNTY","2015","January","407647","383336","24311","6.0","5.8"
"ESSEX COUNTY","2015","February","407440","384373","23067","5.7","5.5"
"ESSEX COUNTY","2015","March","407628","386048","21580","5.3","5.2"
"ESSEX COUNTY","2015","April","406489","386825","19664","4.8","4.6"
"ESSEX COUNTY","2015","May","408154","387349","20805","5.1","4.9"
"ESSEX COUNTY","2015","June","412943","391772","21171","5.1","5.0"
"ESSEX COUNTY","2015","July","411421","389957","21464","5.2","5.0"
"ESSEX COUNTY","2015","August","409714","390283","19431","4.7","4.5"
"ESSEX COUNTY","2015","September","402270","382906","19364","4.8","4.5"
"ESSEX COUNTY","2015","October","405950","388064","17886","4.4","4.2"
"ESSEX COUNTY","2015","November","406400","388780","17620","4.3","4.1"
"ESSEX COUNTY","2015","December","407139","389408","17731","4.4","4.1"
"ESSEX COUNTY","2015","Annual","407766","387425","20341","5.0","4.8"
"ESSEX COUNTY","2014","January","398394","370951","27443","6.9","6.7"
"ESSEX COUNTY","2014","February","400383","372928","27455","6.9","6.7"
"ESSEX COUNTY","2014","March","402967","376174","26793","6.6","6.4"
"ESSEX COUNTY","2014","April","400459","377541","22918","5.7","5.5"
"ESSEX COUNTY","2014","May","402333","378328","24005","6.0","5.7"
"ESSEX COUNTY","2014","June","409737","384776","24961","6.1","5.9"
"ESSEX COUNTY","2014","July","410689","384743","25946","6.3","6.1"
"ESSEX COUNTY","2014","August","407823","382964","24859","6.1","5.7"
"ESSEX COUNTY","2014","September","403640","380154","23486","5.8","5.5"
"ESSEX COUNTY","2014","October","408448","387084","21364","5.2","5.0"
"ESSEX COUNTY","2014","November","409546","388335","21211","5.2","4.9"
"ESSEX COUNTY","2014","December","408184","387790","20394","5.0","4.8"
"ESSEX COUNTY","2014","Annual","405217","380981","24236","6.0","5.7"
"ESSEX COUNTY","2013","January","397699","366348","31351","7.9","7.6"
"ESSEX COUNTY","2013","February","397118","367188","29930","7.5","7.2"
"ESSEX COUNTY","2013","March","397668","368969","28699","7.2","6.9"
"ESSEX COUNTY","2013","April","397390","370839","26551","6.7","6.3"
"ESSEX COUNTY","2013","May","398648","370996","27652","6.9","6.6"
"ESSEX COUNTY","2013","June","405513","375547","29966","7.4","7.1"
"ESSEX COUNTY","2013","July","405638","376264","29374","7.2","7.0"
"ESSEX COUNTY","2013","August","404879","377261","27618","6.8","6.5"
"ESSEX COUNTY","2013","September","397784","370086","27698","7.0","6.5"
"ESSEX COUNTY","2013","October","397212","371039","26173","6.6","6.2"
"ESSEX COUNTY","2013","November","398752","373985","24767","6.2","5.9"
"ESSEX COUNTY","2013","December","398312","373935","24377","6.1","5.9"
"ESSEX COUNTY","2013","Annual","399717","371871","27846","7.0","6.6"
"ESSEX COUNTY","2012","January","394263","363863","30400","7.7","7.4"
"ESSEX COUNTY","2012","February","394719","364441","30278","7.7","7.3"
"ESSEX COUNTY","2012","March","396554","367265","29289","7.4","6.9"
"ESSEX COUNTY","2012","April","393813","367349","26464","6.7","6.3"
"ESSEX COUNTY","2012","May","395771","368267","27504","6.9","6.5"
"ESSEX COUNTY","2012","June","403675","374286","29389","7.3","6.9"
"ESSEX COUNTY","2012","July","402282","372415","29867","7.4","7.1"
"ESSEX COUNTY","2012","August","402178","373588","28590","7.1","6.7"
"ESSEX COUNTY","2012","September","396262","368684","27578","7.0","6.5"
"ESSEX COUNTY","2012","October","399075","372294","26781","6.7","6.3"
"ESSEX COUNTY","2012","November","397902","371722","26180","6.6","6.1"
"ESSEX COUNTY","2012","December","398395","371280","27115","6.8","6.4"
"ESSEX COUNTY","2012","Annual","397907","369621","28286","7.1","6.7"
"ESSEX COUNTY","2011","January","392339","358492","33847","8.6","8.3"
"ESSEX COUNTY","2011","February","391175","358425","32750","8.4","8.0"
"ESSEX COUNTY","2011","March","392906","361300","31606","8.0","7.6"
"ESSEX COUNTY","2011","April","391975","363086","28889","7.4","7.0"
"ESSEX COUNTY","2011","May","390842","361461","29381","7.5","7.1"
"ESSEX COUNTY","2011","June","397182","365955","31227","7.9","7.5"
"ESSEX COUNTY","2011","July","397276","366519","30757","7.7","7.5"
"ESSEX COUNTY","2011","August","399047","369537","29510","7.4","7.0"
"ESSEX COUNTY","2011","September","393129","363446","29683","7.6","7.1"
"ESSEX COUNTY","2011","October","394364","366522","27842","7.1","6.6"
"ESSEX COUNTY","2011","November","394761","367924","26837","6.8","6.4"
"ESSEX COUNTY","2011","December","395595","368252","27343","6.9","6.5"
"ESSEX COUNTY","2011","Annual","394216","364243","29973","7.6","7.2"
"ESSEX COUNTY","2010","January","390536","352794","37742","9.7","9.3"
"ESSEX COUNTY","2010","February","389623","352789","36834","9.5","9.1"
"ESSEX COUNTY","2010","March","390853","355166","35687","9.1","8.7"
"ESSEX COUNTY","2010","April","391465","358435","33030","8.4","8.0"
"ESSEX COUNTY","2010","May","390414","357721","32693","8.4","7.9"
"ESSEX COUNTY","2010","June","396088","362877","33211","8.4","8.1"
"ESSEX COUNTY","2010","July","396199","362814","33385","8.4","8.1"
"ESSEX COUNTY","2010","August","395848","363855","31993","8.1","7.7"
"ESSEX COUNTY","2010","September","388583","356989","31594","8.1","7.8"
"ESSEX COUNTY","2010","October","390838","361064","29774","7.6","7.3"
"ESSEX COUNTY","2010","November","392022","361251","30771","7.8","7.5"
"ESSEX COUNTY","2010","December","392244","361715","30529","7.8","7.4"
"ESSEX COUNTY","2010","Annual","392060","358956","33104","8.4","8.1"
"ESSEX COUNTY","2009","January","379349","347551","31798","8.4","7.8"
"ESSEX COUNTY","2009","February","378037","346400","31637","8.4","8.1"
"ESSEX COUNTY","2009","March","378264","346869","31395","8.3","8.1"
"ESSEX COUNTY","2009","April","378724","348382","30342","8.0","7.5"
"ESSEX COUNTY","2009","May","377812","346549","31263","8.3","8.0"
"ESSEX COUNTY","2009","June","386338","351951","34387","8.9","8.4"
"ESSEX COUNTY","2009","July","386497","352076","34421","8.9","8.5"
"ESSEX COUNTY","2009","August","385904","351960","33944","8.8","8.2"
"ESSEX COUNTY","2009","September","378979","343626","35353","9.3","8.4"
"ESSEX COUNTY","2009","October","380488","346818","33670","8.8","8.1"
"ESSEX COUNTY","2009","November","382166","348509","33657","8.8","7.9"
"ESSEX COUNTY","2009","December","380498","346170","34328","9.0","8.2"
"ESSEX COUNTY","2009","Annual","381088","348072","33016","8.7","8.1"
"ESSEX COUNTY","2008","January","373846","353249","20597","5.5","5.2"
"ESSEX COUNTY","2008","February","371853","352097","19756","5.3","5.1"
"ESSEX COUNTY","2008","March","373019","353513","19506","5.2","4.9"
"ESSEX COUNTY","2008","April","372488","354184","18304","4.9","4.4"
"ESSEX COUNTY","2008","May","372671","353163","19508","5.2","4.9"
"ESSEX COUNTY","2008","June","380887","358747","22140","5.8","5.3"
"ESSEX COUNTY","2008","July","381799","358926","22873","6.0","5.5"
"ESSEX COUNTY","2008","August","382062","358996","23066","6.0","5.4"
"ESSEX COUNTY","2008","September","376665","352266","24399","6.5","5.5"
"ESSEX COUNTY","2008","October","379230","355493","23737","6.3","5.4"
"ESSEX COUNTY","2008","November","380535","355724","24811","6.5","5.7"
"ESSEX COUNTY","2008","December","380137","353645","26492","7.0","6.3"
"ESSEX COUNTY","2008","Annual","377099","355000","22099","5.9","5.3"
"ESSEX COUNTY","2007","January","374128","352145","21983","5.9","5.4"
"ESSEX COUNTY","2007","February","371735","351478","20257","5.4","5.1"
"ESSEX COUNTY","2007","March","372332","353502","18830","5.1","4.7"
"ESSEX COUNTY","2007","April","370167","352499","17668","4.8","4.3"
"ESSEX COUNTY","2007","May","370533","353174","17359","4.7","4.3"
"ESSEX COUNTY","2007","June","378249","358745","19504","5.2","4.6"
"ESSEX COUNTY","2007","July","378499","359533","18966","5.0","4.7"
"ESSEX COUNTY","2007","August","376616","359546","17070","4.5","4.3"
"ESSEX COUNTY","2007","September","371732","353994","17738","4.8","4.4"
"ESSEX COUNTY","2007","October","372263","356559","15704","4.2","4.0"
"ESSEX COUNTY","2007","November","375317","358909","16408","4.4","4.0"
"ESSEX COUNTY","2007","December","374346","356933","17413","4.7","4.3"
"ESSEX COUNTY","2007","Annual","373827","355585","18242","4.9","4.5"
"ESSEX COUNTY","2006","January","371044","349456","21588","5.8","5.3"
"ESSEX COUNTY","2006","February","370546","349155","21391","5.8","5.3"
"ESSEX COUNTY","2006","March","371240","350751","20489","5.5","5.0"
"ESSEX COUNTY","2006","April","369327","349537","19790","5.4","4.6"
"ESSEX COUNTY","2006","May","369858","350864","18994","5.1","4.6"
"ESSEX COUNTY","2006","June","377609","357267","20342","5.4","4.8"
"ESSEX COUNTY","2006","July","378499","358242","20257","5.4","5.0"
"ESSEX COUNTY","2006","August","378581","359649","18932","5.0","4.6"
"ESSEX COUNTY","2006","September","372823","353108","19715","5.3","4.7"
"ESSEX COUNTY","2006","October","374343","356915","17428","4.7","4.1"
"ESSEX COUNTY","2006","November","376064","357760","18304","4.9","4.3"
"ESSEX COUNTY","2006","December","376627","357859","18768","5.0","4.3"
"ESSEX COUNTY","2006","Annual","373881","354214","19667","5.3","4.7"
"ESSEX COUNTY","2005","January","374623","352299","22324","6.0","5.5"
"ESSEX COUNTY","2005","February","373446","351873","21573","5.8","5.5"
"ESSEX COUNTY","2005","March","373414","353011","20403","5.5","5.1"
"ESSEX COUNTY","2005","April","372379","353408","18971","5.1","4.6"
"ESSEX COUNTY","2005","May","372467","353864","18603","5.0","4.7"
"ESSEX COUNTY","2005","June","379228","358803","20425","5.4","4.9"
"ESSEX COUNTY","2005","July","379308","359445","19863","5.2","4.9"
"ESSEX COUNTY","2005","August","379741","361339","18402","4.8","4.5"
"ESSEX COUNTY","2005","September","373712","353414","20298","5.4","4.8"
"ESSEX COUNTY","2005","October","376016","358186","17830","4.7","4.3"
"ESSEX COUNTY","2005","November","377697","358417","19280","5.1","4.5"
"ESSEX COUNTY","2005","December","377228","358148","19080","5.1","4.5"
"ESSEX COUNTY","2005","Annual","375771","356017","19754","5.3","4.8"
"ESSEX COUNTY","2004","January","379478","353907","25571","6.7","6.1"
"ESSEX COUNTY","2004","February","377372","353991","23381","6.2","5.8"
"ESSEX COUNTY","2004","March","377203","354076","23127","6.1","5.7"
"ESSEX COUNTY","2004","April","374366","353431","20935","5.6","5.0"
"ESSEX COUNTY","2004","May","374017","352885","21132","5.7","5.0"
"ESSEX COUNTY","2004","June","381552","358469","23083","6.0","5.4"
"ESSEX COUNTY","2004","July","381448","359139","22309","5.8","5.3"
"ESSEX COUNTY","2004","August","380001","359543","20458","5.4","4.8"
"ESSEX COUNTY","2004","September","372582","352049","20533","5.5","4.8"
"ESSEX COUNTY","2004","October","373962","355503","18459","4.9","4.4"
"ESSEX COUNTY","2004","November","376207","357111","19096","5.1","4.5"
"ESSEX COUNTY","2004","December","375422","356376","19046","5.1","4.5"
"ESSEX COUNTY","2004","Annual","376968","355540","21428","5.7","5.1"
"ESSEX COUNTY","2003","January","382068","356389","25679","6.7","6.3"
"ESSEX COUNTY","2003","February","380089","355716","24373","6.4","6.1"
"ESSEX COUNTY","2003","March","380424","356437","23987","6.3","6.0"
"ESSEX COUNTY","2003","April","378962","355832","23130","6.1","5.5"
"ESSEX COUNTY","2003","May","378621","355204","23417","6.2","5.7"
"ESSEX COUNTY","2003","June","386110","360154","25956","6.7","6.2"
"ESSEX COUNTY","2003","July","384697","359177","25520","6.6","6.0"
"ESSEX COUNTY","2003","August","383668","359133","24535","6.4","5.6"
"ESSEX COUNTY","2003","September","376914","352357","24557","6.5","5.7"
"ESSEX COUNTY","2003","October","378334","355922","22412","5.9","5.2"
"ESSEX COUNTY","2003","November","380563","358165","22398","5.9","5.2"
"ESSEX COUNTY","2003","December","379109","357388","21721","5.7","5.1"
"ESSEX COUNTY","2003","Annual","380797","356823","23974","6.3","5.7"
"ESSEX COUNTY","2002","January","379444","356143","23301","6.1","5.6"
"ESSEX COUNTY","2002","February","380133","357818","22315","5.9","5.4"
"ESSEX COUNTY","2002","March","380514","358053","22461","5.9","5.4"
"ESSEX COUNTY","2002","April","379840","358138","21702","5.7","5.0"
"ESSEX COUNTY","2002","May","380440","358670","21770","5.7","4.9"
"ESSEX COUNTY","2002","June","387626","363701","23925","6.2","5.4"
"ESSEX COUNTY","2002","July","385878","362286","23592","6.1","5.4"
"ESSEX COUNTY","2002","August","386571","363581","22990","5.9","5.1"
"ESSEX COUNTY","2002","September","381185","357976","23209","6.1","5.2"
"ESSEX COUNTY","2002","October","382016","360059","21957","5.7","4.9"
"ESSEX COUNTY","2002","November","382021","360223","21798","5.7","5.1"
"ESSEX COUNTY","2002","December","381473","359728","21745","5.7","5.3"
"ESSEX COUNTY","2002","Annual","382262","359698","22564","5.9","5.2"
"ESSEX COUNTY","2001","January","372723","359537","13186","3.5","3.7"
"ESSEX COUNTY","2001","February","372388","359562","12826","3.4","3.5"
"ESSEX COUNTY","2001","March","374470","361053","13417","3.6","3.6"
"ESSEX COUNTY","2001","April","372004","359479","12525","3.4","3.2"
"ESSEX COUNTY","2001","May","372802","359765","13037","3.5","3.3"
"ESSEX COUNTY","2001","June","380577","364889","15688","4.1","3.8"
"ESSEX COUNTY","2001","July","381436","365237","16199","4.2","3.9"
"ESSEX COUNTY","2001","August","380500","364238","16262","4.3","3.9"
"ESSEX COUNTY","2001","September","375396","358431","16965","4.5","4.0"
"ESSEX COUNTY","2001","October","377275","361068","16207","4.3","4.0"
"ESSEX COUNTY","2001","November","380000","361722","18278","4.8","4.2"
"ESSEX COUNTY","2001","December","381284","362280","19004","5.0","4.4"
"ESSEX COUNTY","2001","Annual","376738","361438","15300","4.1","3.8"
"FRANKLIN COUNTY","2020","January","41369","39962","1407","3.4","3.5"
"FRANKLIN COUNTY","2020","February","41514","40220","1294","3.1","3.3"
"FRANKLIN COUNTY","2020","March","40989","39573","1416","3.5","3.6"
"FRANKLIN COUNTY","2020","April","36875","31469","5406","14.7","16.7"
"FRANKLIN COUNTY","2020","May","39096","34176","4920","12.6","15.6"
"FRANKLIN COUNTY","2020","June","40546","35777","4769","11.8","14.5"
"FRANKLIN COUNTY","2020","July","40333","35983","4350","10.8","13.0"
"FRANKLIN COUNTY","2020","August","40155","36736","3419","8.5","10.3"
"FRANKLIN COUNTY","2020","September","39902","36783","3119","7.8","9.8"
"FRANKLIN COUNTY","2020","October","40624","37930","2694","6.6","8.1"
"FRANKLIN COUNTY","2020","November","40440","37863","2577","6.4","7.6"
"FRANKLIN COUNTY","2020","December","40822","38028","2794","6.8","7.4"
"FRANKLIN COUNTY","2020","Annual","40222","37042","3180","7.9","9.4"
"FRANKLIN COUNTY","2019","January","41581","39976","1605","3.9","4.0"
"FRANKLIN COUNTY","2019","February","41556","40071","1485","3.6","3.6"
"FRANKLIN COUNTY","2019","March","41417","40045","1372","3.3","3.4"
"FRANKLIN COUNTY","2019","April","41292","40149","1143","2.8","2.8"
"FRANKLIN COUNTY","2019","May","41479","40364","1115","2.7","2.9"
"FRANKLIN COUNTY","2019","June","41520","40344","1176","2.8","3.2"
"FRANKLIN COUNTY","2019","July","41631","40451","1180","2.8","3.3"
"FRANKLIN COUNTY","2019","August","41372","40269","1103","2.7","3.0"
"FRANKLIN COUNTY","2019","September","40970","39969","1001","2.4","2.8"
"FRANKLIN COUNTY","2019","October","41247","40301","946","2.3","2.6"
"FRANKLIN COUNTY","2019","November","41067","40116","951","2.3","2.5"
"FRANKLIN COUNTY","2019","December","41147","40152","995","2.4","2.6"
"FRANKLIN COUNTY","2019","Annual","41357","40184","1173","2.8","3.1"
"FRANKLIN COUNTY","2018","January","40639","39000","1639","4.0","4.3"
"FRANKLIN COUNTY","2018","February","41016","39397","1619","3.9","4.2"
"FRANKLIN COUNTY","2018","March","41201","39725","1476","3.6","3.8"
"FRANKLIN COUNTY","2018","April","41320","40040","1280","3.1","3.3"
"FRANKLIN COUNTY","2018","May","41197","40010","1187","2.9","3.3"
"FRANKLIN COUNTY","2018","June","41748","40364","1384","3.3","3.7"
"FRANKLIN COUNTY","2018","July","41954","40669","1285","3.1","3.7"
"FRANKLIN COUNTY","2018","August","41701","40507","1194","2.9","3.3"
"FRANKLIN COUNTY","2018","September","41420","40284","1136","2.7","3.2"
"FRANKLIN COUNTY","2018","October","41570","40516","1054","2.5","2.9"
"FRANKLIN COUNTY","2018","November","41712","40670","1042","2.5","2.8"
"FRANKLIN COUNTY","2018","December","41861","40673","1188","2.8","3.0"
"FRANKLIN COUNTY","2018","Annual","41445","40155","1290","3.1","3.4"
"FRANKLIN COUNTY","2017","January","40063","38352","1711","4.3","4.5"
"FRANKLIN COUNTY","2017","February","40362","38715","1647","4.1","4.4"
"FRANKLIN COUNTY","2017","March","40695","39187","1508","3.7","4.0"
"FRANKLIN COUNTY","2017","April","40545","39207","1338","3.3","3.6"
"FRANKLIN COUNTY","2017","May","40462","39130","1332","3.3","3.7"
"FRANKLIN COUNTY","2017","June","40977","39589","1388","3.4","4.0"
"FRANKLIN COUNTY","2017","July","41052","39650","1402","3.4","4.1"
"FRANKLIN COUNTY","2017","August","41112","39741","1371","3.3","3.8"
"FRANKLIN COUNTY","2017","September","40576","39276","1300","3.2","3.7"
"FRANKLIN COUNTY","2017","October","40630","39431","1199","3.0","3.3"
"FRANKLIN COUNTY","2017","November","40797","39593","1204","3.0","3.3"
"FRANKLIN COUNTY","2017","December","40886","39585","1301","3.2","3.4"
"FRANKLIN COUNTY","2017","Annual","40680","39288","1392","3.4","3.8"
"FRANKLIN COUNTY","2016","January","39246","37319","1927","4.9","4.9"
"FRANKLIN COUNTY","2016","February","39557","37728","1829","4.6","4.7"
"FRANKLIN COUNTY","2016","March","39744","38011","1733","4.4","4.5"
"FRANKLIN COUNTY","2016","April","39581","38135","1446","3.7","3.9"
"FRANKLIN COUNTY","2016","May","39358","38000","1358","3.5","3.9"
"FRANKLIN COUNTY","2016","June","39758","38305","1453","3.7","4.2"
"FRANKLIN COUNTY","2016","July","39923","38471","1452","3.6","4.2"
"FRANKLIN COUNTY","2016","August","39803","38510","1293","3.2","3.8"
"FRANKLIN COUNTY","2016","September","39230","37990","1240","3.2","3.8"
"FRANKLIN COUNTY","2016","October","39379","38245","1134","2.9","3.5"
"FRANKLIN COUNTY","2016","November","39433","38312","1121","2.8","3.3"
"FRANKLIN COUNTY","2016","December","39491","38264","1227","3.1","3.5"
"FRANKLIN COUNTY","2016","Annual","39542","38108","1434","3.6","4.0"
"FRANKLIN COUNTY","2015","January","39654","37426","2228","5.6","5.8"
"FRANKLIN COUNTY","2015","February","39837","37726","2111","5.3","5.5"
"FRANKLIN COUNTY","2015","March","39825","37846","1979","5.0","5.2"
"FRANKLIN COUNTY","2015","April","39618","37971","1647","4.2","4.6"
"FRANKLIN COUNTY","2015","May","39781","38091","1690","4.2","4.9"
"FRANKLIN COUNTY","2015","June","40090","38346","1744","4.4","5.0"
"FRANKLIN COUNTY","2015","July","39576","37805","1771","4.5","5.0"
"FRANKLIN COUNTY","2015","August","39396","37821","1575","4.0","4.5"
"FRANKLIN COUNTY","2015","September","38483","36961","1522","4.0","4.5"
"FRANKLIN COUNTY","2015","October","39017","37544","1473","3.8","4.2"
"FRANKLIN COUNTY","2015","November","38905","37488","1417","3.6","4.1"
"FRANKLIN COUNTY","2015","December","39150","37577","1573","4.0","4.1"
"FRANKLIN COUNTY","2015","Annual","39445","37717","1728","4.4","4.8"
"FRANKLIN COUNTY","2014","January","39032","36566","2466","6.3","6.7"
"FRANKLIN COUNTY","2014","February","39382","36854","2528","6.4","6.7"
"FRANKLIN COUNTY","2014","March","39580","37167","2413","6.1","6.4"
"FRANKLIN COUNTY","2014","April","39562","37554","2008","5.1","5.5"
"FRANKLIN COUNTY","2014","May","39620","37558","2062","5.2","5.7"
"FRANKLIN COUNTY","2014","June","39853","37752","2101","5.3","5.9"
"FRANKLIN COUNTY","2014","July","39664","37438","2226","5.6","6.1"
"FRANKLIN COUNTY","2014","August","39351","37357","1994","5.1","5.7"
"FRANKLIN COUNTY","2014","September","39063","37144","1919","4.9","5.5"
"FRANKLIN COUNTY","2014","October","39774","37989","1785","4.5","5.0"
"FRANKLIN COUNTY","2014","November","39666","37899","1767","4.5","4.9"
"FRANKLIN COUNTY","2014","December","39843","38002","1841","4.6","4.8"
"FRANKLIN COUNTY","2014","Annual","39533","37440","2093","5.3","5.7"
"FRANKLIN COUNTY","2013","January","39355","36576","2779","7.1","7.6"
"FRANKLIN COUNTY","2013","February","39465","36818","2647","6.7","7.2"
"FRANKLIN COUNTY","2013","March","39425","36900","2525","6.4","6.9"
"FRANKLIN COUNTY","2013","April","39707","37399","2308","5.8","6.3"
"FRANKLIN COUNTY","2013","May","39832","37475","2357","5.9","6.6"
"FRANKLIN COUNTY","2013","June","39913","37403","2510","6.3","7.1"
"FRANKLIN COUNTY","2013","July","39445","36903","2542","6.4","7.0"
"FRANKLIN COUNTY","2013","August","39029","36716","2313","5.9","6.5"
"FRANKLIN COUNTY","2013","September","38984","36681","2303","5.9","6.5"
"FRANKLIN COUNTY","2013","October","38874","36708","2166","5.6","6.2"
"FRANKLIN COUNTY","2013","November","38897","36799","2098","5.4","5.9"
"FRANKLIN COUNTY","2013","December","39264","37086","2178","5.5","5.9"
"FRANKLIN COUNTY","2013","Annual","39349","36955","2394","6.1","6.6"
"FRANKLIN COUNTY","2012","January","39693","36923","2770","7.0","7.4"
"FRANKLIN COUNTY","2012","February","39778","36973","2805","7.1","7.3"
"FRANKLIN COUNTY","2012","March","40024","37408","2616","6.5","6.9"
"FRANKLIN COUNTY","2012","April","40115","37818","2297","5.7","6.3"
"FRANKLIN COUNTY","2012","May","40154","37828","2326","5.8","6.5"
"FRANKLIN COUNTY","2012","June","40567","38089","2478","6.1","6.9"
"FRANKLIN COUNTY","2012","July","39739","37137","2602","6.5","7.1"
"FRANKLIN COUNTY","2012","August","39503","37083","2420","6.1","6.7"
"FRANKLIN COUNTY","2012","September","39618","37397","2221","5.6","6.5"
"FRANKLIN COUNTY","2012","October","39741","37564","2177","5.5","6.3"
"FRANKLIN COUNTY","2012","November","39461","37364","2097","5.3","6.1"
"FRANKLIN COUNTY","2012","December","39644","37285","2359","6.0","6.4"
"FRANKLIN COUNTY","2012","Annual","39837","37406","2431","6.1","6.7"
"FRANKLIN COUNTY","2011","January","39632","36612","3020","7.6","8.3"
"FRANKLIN COUNTY","2011","February","39643","36759","2884","7.3","8.0"
"FRANKLIN COUNTY","2011","March","39765","36984","2781","7.0","7.6"
"FRANKLIN COUNTY","2011","April","39726","37206","2520","6.3","7.0"
"FRANKLIN COUNTY","2011","May","39794","37295","2499","6.3","7.1"
"FRANKLIN COUNTY","2011","June","40178","37479","2699","6.7","7.5"
"FRANKLIN COUNTY","2011","July","39868","37181","2687","6.7","7.5"
"FRANKLIN COUNTY","2011","August","39699","37161","2538","6.4","7.0"
"FRANKLIN COUNTY","2011","September","39417","36936","2481","6.3","7.1"
"FRANKLIN COUNTY","2011","October","39620","37303","2317","5.8","6.6"
"FRANKLIN COUNTY","2011","November","39358","37124","2234","5.7","6.4"
"FRANKLIN COUNTY","2011","December","39782","37373","2409","6.1","6.5"
"FRANKLIN COUNTY","2011","Annual","39707","37118","2589","6.5","7.2"
"FRANKLIN COUNTY","2010","January","39683","36171","3512","8.9","9.3"
"FRANKLIN COUNTY","2010","February","39617","36197","3420","8.6","9.1"
"FRANKLIN COUNTY","2010","March","39747","36409","3338","8.4","8.7"
"FRANKLIN COUNTY","2010","April","40061","37104","2957","7.4","8.0"
"FRANKLIN COUNTY","2010","May","40133","37307","2826","7.0","7.9"
"FRANKLIN COUNTY","2010","June","40604","37636","2968","7.3","8.1"
"FRANKLIN COUNTY","2010","July","40574","37544","3030","7.5","8.1"
"FRANKLIN COUNTY","2010","August","40206","37376","2830","7.0","7.7"
"FRANKLIN COUNTY","2010","September","39667","36941","2726","6.9","7.8"
"FRANKLIN COUNTY","2010","October","39892","37331","2561","6.4","7.3"
"FRANKLIN COUNTY","2010","November","39758","37120","2638","6.6","7.5"
"FRANKLIN COUNTY","2010","December","39966","37313","2653","6.6","7.4"
"FRANKLIN COUNTY","2010","Annual","39992","37037","2955","7.4","8.1"
"FRANKLIN COUNTY","2009","January","38460","35553","2907","7.6","7.8"
"FRANKLIN COUNTY","2009","February","39329","36487","2842","7.2","8.1"
"FRANKLIN COUNTY","2009","March","39254","36462","2792","7.1","8.1"
"FRANKLIN COUNTY","2009","April","39485","36932","2553","6.5","7.5"
"FRANKLIN COUNTY","2009","May","39425","36656","2769","7.0","8.0"
"FRANKLIN COUNTY","2009","June","38865","35777","3088","7.9","8.4"
"FRANKLIN COUNTY","2009","July","38329","35177","3152","8.2","8.5"
"FRANKLIN COUNTY","2009","August","37987","34876","3111","8.2","8.2"
"FRANKLIN COUNTY","2009","September","38675","35539","3136","8.1","8.4"
"FRANKLIN COUNTY","2009","October","39206","36252","2954","7.5","8.1"
"FRANKLIN COUNTY","2009","November","39124","36112","3012","7.7","7.9"
"FRANKLIN COUNTY","2009","December","38825","35689","3136","8.1","8.2"
"FRANKLIN COUNTY","2009","Annual","38913","35959","2954","7.6","8.1"
"FRANKLIN COUNTY","2008","January","38319","36278","2041","5.3","5.2"
"FRANKLIN COUNTY","2008","February","39208","37324","1884","4.8","5.1"
"FRANKLIN COUNTY","2008","March","39238","37345","1893","4.8","4.9"
"FRANKLIN COUNTY","2008","April","39223","37507","1716","4.4","4.4"
"FRANKLIN COUNTY","2008","May","39260","37457","1803","4.6","4.9"
"FRANKLIN COUNTY","2008","June","38817","36751","2066","5.3","5.3"
"FRANKLIN COUNTY","2008","July","38080","36000","2080","5.5","5.5"
"FRANKLIN COUNTY","2008","August","37734","35691","2043","5.4","5.4"
"FRANKLIN COUNTY","2008","September","38893","36838","2055","5.3","5.5"
"FRANKLIN COUNTY","2008","October","39451","37470","1981","5.0","5.4"
"FRANKLIN COUNTY","2008","November","39585","37374","2211","5.6","5.7"
"FRANKLIN COUNTY","2008","December","39429","36988","2441","6.2","6.3"
"FRANKLIN COUNTY","2008","Annual","38937","36919","2018","5.2","5.3"
"FRANKLIN COUNTY","2007","January","38980","36828","2152","5.5","5.4"
"FRANKLIN COUNTY","2007","February","39692","37750","1942","4.9","5.1"
"FRANKLIN COUNTY","2007","March","39869","38133","1736","4.4","4.7"
"FRANKLIN COUNTY","2007","April","39445","37834","1611","4.1","4.3"
"FRANKLIN COUNTY","2007","May","39701","38133","1568","3.9","4.3"
"FRANKLIN COUNTY","2007","June","39008","37273","1735","4.4","4.6"
"FRANKLIN COUNTY","2007","July","38166","36451","1715","4.5","4.7"
"FRANKLIN COUNTY","2007","August","37636","36124","1512","4.0","4.3"
"FRANKLIN COUNTY","2007","September","38808","37241","1567","4.0","4.4"
"FRANKLIN COUNTY","2007","October","39226","37837","1389","3.5","4.0"
"FRANKLIN COUNTY","2007","November","39440","37966","1474","3.7","4.0"
"FRANKLIN COUNTY","2007","December","39277","37648","1629","4.1","4.3"
"FRANKLIN COUNTY","2007","Annual","39104","37435","1669","4.3","4.5"
"FRANKLIN COUNTY","2006","January","39006","36937","2069","5.3","5.3"
"FRANKLIN COUNTY","2006","February","40064","38015","2049","5.1","5.3"
"FRANKLIN COUNTY","2006","March","40115","38172","1943","4.8","5.0"
"FRANKLIN COUNTY","2006","April","40001","38298","1703","4.3","4.6"
"FRANKLIN COUNTY","2006","May","40153","38497","1656","4.1","4.6"
"FRANKLIN COUNTY","2006","June","39585","37733","1852","4.7","4.8"
"FRANKLIN COUNTY","2006","July","38694","36880","1814","4.7","5.0"
"FRANKLIN COUNTY","2006","August","38483","36853","1630","4.2","4.6"
"FRANKLIN COUNTY","2006","September","39507","37831","1676","4.2","4.7"
"FRANKLIN COUNTY","2006","October","39997","38541","1456","3.6","4.1"
"FRANKLIN COUNTY","2006","November","40075","38447","1628","4.1","4.3"
"FRANKLIN COUNTY","2006","December","39992","38343","1649","4.1","4.3"
"FRANKLIN COUNTY","2006","Annual","39639","37879","1760","4.4","4.7"
"FRANKLIN COUNTY","2005","January","39056","37032","2024","5.2","5.5"
"FRANKLIN COUNTY","2005","February","40105","38101","2004","5.0","5.5"
"FRANKLIN COUNTY","2005","March","40147","38290","1857","4.6","5.1"
"FRANKLIN COUNTY","2005","April","40080","38471","1609","4.0","4.6"
"FRANKLIN COUNTY","2005","May","40235","38669","1566","3.9","4.7"
"FRANKLIN COUNTY","2005","June","39714","37981","1733","4.4","4.9"
"FRANKLIN COUNTY","2005","July","38727","37023","1704","4.4","4.9"
"FRANKLIN COUNTY","2005","August","38372","36851","1521","4.0","4.5"
"FRANKLIN COUNTY","2005","September","39178","37556","1622","4.1","4.8"
"FRANKLIN COUNTY","2005","October","39921","38427","1494","3.7","4.3"
"FRANKLIN COUNTY","2005","November","39784","38178","1606","4.0","4.5"
"FRANKLIN COUNTY","2005","December","39608","37943","1665","4.2","4.5"
"FRANKLIN COUNTY","2005","Annual","39577","37877","1700","4.3","4.8"
"FRANKLIN COUNTY","2004","January","39588","37430","2158","5.5","6.1"
"FRANKLIN COUNTY","2004","February","40334","38366","1968","4.9","5.8"
"FRANKLIN COUNTY","2004","March","40457","38548","1909","4.7","5.7"
"FRANKLIN COUNTY","2004","April","40327","38708","1619","4.0","5.0"
"FRANKLIN COUNTY","2004","May","40330","38736","1594","4.0","5.0"
"FRANKLIN COUNTY","2004","June","39957","38153","1804","4.5","5.4"
"FRANKLIN COUNTY","2004","July","38834","37115","1719","4.4","5.3"
"FRANKLIN COUNTY","2004","August","38491","36924","1567","4.1","4.8"
"FRANKLIN COUNTY","2004","September","39301","37863","1438","3.7","4.8"
"FRANKLIN COUNTY","2004","October","39889","38518","1371","3.4","4.4"
"FRANKLIN COUNTY","2004","November","40060","38592","1468","3.7","4.5"
"FRANKLIN COUNTY","2004","December","39703","38118","1585","4.0","4.5"
"FRANKLIN COUNTY","2004","Annual","39772","38089","1683","4.2","5.1"
"FRANKLIN COUNTY","2003","January","40160","38084","2076","5.2","6.3"
"FRANKLIN COUNTY","2003","February","40921","38951","1970","4.8","6.1"
"FRANKLIN COUNTY","2003","March","40921","38976","1945","4.8","6.0"
"FRANKLIN COUNTY","2003","April","40674","38943","1731","4.3","5.5"
"FRANKLIN COUNTY","2003","May","40700","38989","1711","4.2","5.7"
"FRANKLIN COUNTY","2003","June","40463","38534","1929","4.8","6.2"
"FRANKLIN COUNTY","2003","July","39272","37383","1889","4.8","6.0"
"FRANKLIN COUNTY","2003","August","39201","37384","1817","4.6","5.6"
"FRANKLIN COUNTY","2003","September","39954","38200","1754","4.4","5.7"
"FRANKLIN COUNTY","2003","October","40368","38773","1595","4.0","5.2"
"FRANKLIN COUNTY","2003","November","40367","38746","1621","4.0","5.2"
"FRANKLIN COUNTY","2003","December","40363","38691","1672","4.1","5.1"
"FRANKLIN COUNTY","2003","Annual","40280","38471","1809","4.5","5.7"
"FRANKLIN COUNTY","2002","January","39458","37773","1685","4.3","5.6"
"FRANKLIN COUNTY","2002","February","40406","38778","1628","4.0","5.4"
"FRANKLIN COUNTY","2002","March","40476","38800","1676","4.1","5.4"
"FRANKLIN COUNTY","2002","April","40130","38667","1463","3.6","5.0"
"FRANKLIN COUNTY","2002","May","40182","38776","1406","3.5","4.9"
"FRANKLIN COUNTY","2002","June","40068","38353","1715","4.3","5.4"
"FRANKLIN COUNTY","2002","July","39321","37574","1747","4.4","5.4"
"FRANKLIN COUNTY","2002","August","38820","37192","1628","4.2","5.1"
"FRANKLIN COUNTY","2002","September","39865","38279","1586","4.0","5.2"
"FRANKLIN COUNTY","2002","October","40271","38842","1429","3.5","4.9"
"FRANKLIN COUNTY","2002","November","40380","38845","1535","3.8","5.1"
"FRANKLIN COUNTY","2002","December","40343","38701","1642","4.1","5.3"
"FRANKLIN COUNTY","2002","Annual","39977","38382","1595","4.0","5.2"
"FRANKLIN COUNTY","2001","January","38576","37139","1437","3.7","3.7"
"FRANKLIN COUNTY","2001","February","39279","37940","1339","3.4","3.5"
"FRANKLIN COUNTY","2001","March","39580","38140","1440","3.6","3.6"
"FRANKLIN COUNTY","2001","April","39175","37939","1236","3.2","3.2"
"FRANKLIN COUNTY","2001","May","39144","38073","1071","2.7","3.3"
"FRANKLIN COUNTY","2001","June","38901","37673","1228","3.2","3.8"
"FRANKLIN COUNTY","2001","July","37999","36781","1218","3.2","3.9"
"FRANKLIN COUNTY","2001","August","37554","36400","1154","3.1","3.9"
"FRANKLIN COUNTY","2001","September","38916","37802","1114","2.9","4.0"
"FRANKLIN COUNTY","2001","October","39521","38496","1025","2.6","4.0"
"FRANKLIN COUNTY","2001","November","39626","38556","1070","2.7","4.2"
"FRANKLIN COUNTY","2001","December","39528","38326","1202","3.0","4.4"
"FRANKLIN COUNTY","2001","Annual","38983","37772","1211","3.1","3.8"
"HAMPDEN COUNTY","2020","January","227628","216822","10806","4.7","3.5"
"HAMPDEN COUNTY","2020","February","228595","218476","10119","4.4","3.3"
"HAMPDEN COUNTY","2020","March","225546","215316","10230","4.5","3.6"
"HAMPDEN COUNTY","2020","April","209502","170872","38630","18.4","16.7"
"HAMPDEN COUNTY","2020","May","222608","184413","38195","17.2","15.6"
"HAMPDEN COUNTY","2020","June","229327","191955","37372","16.3","14.5"
"HAMPDEN COUNTY","2020","July","229450","194700","34750","15.1","13.0"
"HAMPDEN COUNTY","2020","August","228284","200126","28158","12.3","10.3"
"HAMPDEN COUNTY","2020","September","226545","199916","26629","11.8","9.8"
"HAMPDEN COUNTY","2020","October","228222","206580","21642","9.5","8.1"
"HAMPDEN COUNTY","2020","November","228085","207457","20628","9.0","7.6"
"HAMPDEN COUNTY","2020","December","228145","207413","20732","9.1","7.4"
"HAMPDEN COUNTY","2020","Annual","225995","201171","24824","11.0","9.4"
"HAMPDEN COUNTY","2019","January","232101","219465","12636","5.4","4.0"
"HAMPDEN COUNTY","2019","February","233309","221657","11652","5.0","3.6"
"HAMPDEN COUNTY","2019","March","232601","221802","10799","4.6","3.4"
"HAMPDEN COUNTY","2019","April","231286","222366","8920","3.9","2.8"
"HAMPDEN COUNTY","2019","May","231304","221854","9450","4.1","2.9"
"HAMPDEN COUNTY","2019","June","230584","219947","10637","4.6","3.2"
"HAMPDEN COUNTY","2019","July","229965","218847","11118","4.8","3.3"
"HAMPDEN COUNTY","2019","August","229373","218962","10411","4.5","3.0"
"HAMPDEN COUNTY","2019","September","229340","220253","9087","4.0","2.8"
"HAMPDEN COUNTY","2019","October","230332","222003","8329","3.6","2.6"
"HAMPDEN COUNTY","2019","November","230634","222535","8099","3.5","2.5"
"HAMPDEN COUNTY","2019","December","230543","221983","8560","3.7","2.6"
"HAMPDEN COUNTY","2019","Annual","230948","220973","9975","4.3","3.1"
"HAMPDEN COUNTY","2018","January","227991","214887","13104","5.7","4.3"
"HAMPDEN COUNTY","2018","February","230862","218087","12775","5.5","4.2"
"HAMPDEN COUNTY","2018","March","231367","219411","11956","5.2","3.8"
"HAMPDEN COUNTY","2018","April","231380","220991","10389","4.5","3.3"
"HAMPDEN COUNTY","2018","May","230727","220144","10583","4.6","3.3"
"HAMPDEN COUNTY","2018","June","232908","220839","12069","5.2","3.7"
"HAMPDEN COUNTY","2018","July","232074","219915","12159","5.2","3.7"
"HAMPDEN COUNTY","2018","August","231269","220291","10978","4.7","3.3"
"HAMPDEN COUNTY","2018","September","232051","221777","10274","4.4","3.2"
"HAMPDEN COUNTY","2018","October","232977","223601","9376","4.0","2.9"
"HAMPDEN COUNTY","2018","November","233887","224933","8954","3.8","2.8"
"HAMPDEN COUNTY","2018","December","233941","224138","9803","4.2","3.0"
"HAMPDEN COUNTY","2018","Annual","231786","220751","11035","4.8","3.4"
"HAMPDEN COUNTY","2017","January","225114","211220","13894","6.2","4.5"
"HAMPDEN COUNTY","2017","February","227642","214151","13491","5.9","4.4"
"HAMPDEN COUNTY","2017","March","228066","215804","12262","5.4","4.0"
"HAMPDEN COUNTY","2017","April","227903","217104","10799","4.7","3.6"
"HAMPDEN COUNTY","2017","May","226591","215463","11128","4.9","3.7"
"HAMPDEN COUNTY","2017","June","228320","215843","12477","5.5","4.0"
"HAMPDEN COUNTY","2017","July","227850","214756","13094","5.7","4.1"
"HAMPDEN COUNTY","2017","August","227203","214997","12206","5.4","3.8"
"HAMPDEN COUNTY","2017","September","227018","215669","11349","5.0","3.7"
"HAMPDEN COUNTY","2017","October","227627","217451","10176","4.5","3.3"
"HAMPDEN COUNTY","2017","November","228618","218425","10193","4.5","3.3"
"HAMPDEN COUNTY","2017","December","228823","218356","10467","4.6","3.4"
"HAMPDEN COUNTY","2017","Annual","227565","215770","11795","5.2","3.8"
"HAMPDEN COUNTY","2016","January","220895","206325","14570","6.6","4.9"
"HAMPDEN COUNTY","2016","February","223071","209173","13898","6.2","4.7"
"HAMPDEN COUNTY","2016","March","224003","210622","13381","6.0","4.5"
"HAMPDEN COUNTY","2016","April","222928","211153","11775","5.3","3.9"
"HAMPDEN COUNTY","2016","May","220715","209250","11465","5.2","3.9"
"HAMPDEN COUNTY","2016","June","222037","209441","12596","5.7","4.2"
"HAMPDEN COUNTY","2016","July","222761","209669","13092","5.9","4.2"
"HAMPDEN COUNTY","2016","August","221821","209990","11831","5.3","3.8"
"HAMPDEN COUNTY","2016","September","221300","209655","11645","5.3","3.8"
"HAMPDEN COUNTY","2016","October","222066","211810","10256","4.6","3.5"
"HAMPDEN COUNTY","2016","November","222358","212472","9886","4.4","3.3"
"HAMPDEN COUNTY","2016","December","222781","212134","10647","4.8","3.5"
"HAMPDEN COUNTY","2016","Annual","222228","210141","12087","5.4","4.0"
"HAMPDEN COUNTY","2015","January","223503","206252","17251","7.7","5.8"
"HAMPDEN COUNTY","2015","February","225020","208769","16251","7.2","5.5"
"HAMPDEN COUNTY","2015","March","224206","208984","15222","6.8","5.2"
"HAMPDEN COUNTY","2015","April","223925","210283","13642","6.1","4.6"
"HAMPDEN COUNTY","2015","May","223970","209550","14420","6.4","4.9"
"HAMPDEN COUNTY","2015","June","224708","210005","14703","6.5","5.0"
"HAMPDEN COUNTY","2015","July","222801","207275","15526","7.0","5.0"
"HAMPDEN COUNTY","2015","August","221422","207457","13965","6.3","4.5"
"HAMPDEN COUNTY","2015","September","218539","205471","13068","6.0","4.5"
"HAMPDEN COUNTY","2015","October","221167","209031","12136","5.5","4.2"
"HAMPDEN COUNTY","2015","November","221349","209408","11941","5.4","4.1"
"HAMPDEN COUNTY","2015","December","221936","209471","12465","5.6","4.1"
"HAMPDEN COUNTY","2015","Annual","222712","208496","14216","6.4","4.8"
"HAMPDEN COUNTY","2014","January","219387","200228","19159","8.7","6.7"
"HAMPDEN COUNTY","2014","February","221719","202546","19173","8.6","6.7"
"HAMPDEN COUNTY","2014","March","222994","204439","18555","8.3","6.4"
"HAMPDEN COUNTY","2014","April","221766","206210","15556","7.0","5.5"
"HAMPDEN COUNTY","2014","May","221716","205295","16421","7.4","5.7"
"HAMPDEN COUNTY","2014","June","222741","205608","17133","7.7","5.9"
"HAMPDEN COUNTY","2014","July","223329","204922","18407","8.2","6.1"
"HAMPDEN COUNTY","2014","August","222700","205528","17172","7.7","5.7"
"HAMPDEN COUNTY","2014","September","220579","204392","16187","7.3","5.5"
"HAMPDEN COUNTY","2014","October","223713","208863","14850","6.6","5.0"
"HAMPDEN COUNTY","2014","November","223831","209017","14814","6.6","4.9"
"HAMPDEN COUNTY","2014","December","223595","208892","14703","6.6","4.8"
"HAMPDEN COUNTY","2014","Annual","222339","205495","16844","7.6","5.7"
"HAMPDEN COUNTY","2013","January","219877","198315","21562","9.8","7.6"
"HAMPDEN COUNTY","2013","February","220672","200390","20282","9.2","7.2"
"HAMPDEN COUNTY","2013","March","220996","201500","19496","8.8","6.9"
"HAMPDEN COUNTY","2013","April","221348","203446","17902","8.1","6.3"
"HAMPDEN COUNTY","2013","May","220820","202177","18643","8.4","6.6"
"HAMPDEN COUNTY","2013","June","221748","201710","20038","9.0","7.1"
"HAMPDEN COUNTY","2013","July","220260","200185","20075","9.1","7.0"
"HAMPDEN COUNTY","2013","August","219834","200655","19179","8.7","6.5"
"HAMPDEN COUNTY","2013","September","219764","201311","18453","8.4","6.5"
"HAMPDEN COUNTY","2013","October","219205","201859","17346","7.9","6.2"
"HAMPDEN COUNTY","2013","November","219578","202780","16798","7.7","5.9"
"HAMPDEN COUNTY","2013","December","220275","203482","16793","7.6","5.9"
"HAMPDEN COUNTY","2013","Annual","220365","201484","18881","8.6","6.6"
"HAMPDEN COUNTY","2012","January","218912","197874","21038","9.6","7.4"
"HAMPDEN COUNTY","2012","February","220406","199956","20450","9.3","7.3"
"HAMPDEN COUNTY","2012","March","222368","202769","19599","8.8","6.9"
"HAMPDEN COUNTY","2012","April","221304","203878","17426","7.9","6.3"
"HAMPDEN COUNTY","2012","May","221778","203369","18409","8.3","6.5"
"HAMPDEN COUNTY","2012","June","223659","203898","19761","8.8","6.9"
"HAMPDEN COUNTY","2012","July","220015","199558","20457","9.3","7.1"
"HAMPDEN COUNTY","2012","August","219162","199860","19302","8.8","6.7"
"HAMPDEN COUNTY","2012","September","219241","200935","18306","8.3","6.5"
"HAMPDEN COUNTY","2012","October","220669","203311","17358","7.9","6.3"
"HAMPDEN COUNTY","2012","November","219526","202263","17263","7.9","6.1"
"HAMPDEN COUNTY","2012","December","219560","201339","18221","8.3","6.4"
"HAMPDEN COUNTY","2012","Annual","220550","201584","18966","8.6","6.7"
"HAMPDEN COUNTY","2011","January","220440","196582","23858","10.8","8.3"
"HAMPDEN COUNTY","2011","February","221423","198390","23033","10.4","8.0"
"HAMPDEN COUNTY","2011","March","221759","199883","21876","9.9","7.6"
"HAMPDEN COUNTY","2011","April","220504","200816","19688","8.9","7.0"
"HAMPDEN COUNTY","2011","May","219731","199751","19980","9.1","7.1"
"HAMPDEN COUNTY","2011","June","221173","200080","21093","9.5","7.5"
"HAMPDEN COUNTY","2011","July","219185","198045","21140","9.6","7.5"
"HAMPDEN COUNTY","2011","August","219133","198911","20222","9.2","7.0"
"HAMPDEN COUNTY","2011","September","219603","199759","19844","9.0","7.1"
"HAMPDEN COUNTY","2011","October","219599","201410","18189","8.3","6.6"
"HAMPDEN COUNTY","2011","November","218682","200833","17849","8.2","6.4"
"HAMPDEN COUNTY","2011","December","219483","201045","18438","8.4","6.5"
"HAMPDEN COUNTY","2011","Annual","220059","199625","20434","9.3","7.2"
"HAMPDEN COUNTY","2010","January","219577","193866","25711","11.7","9.3"
"HAMPDEN COUNTY","2010","February","220746","195913","24833","11.2","9.1"
"HAMPDEN COUNTY","2010","March","221720","197815","23905","10.8","8.7"
"HAMPDEN COUNTY","2010","April","221492","199909","21583","9.7","8.0"
"HAMPDEN COUNTY","2010","May","221130","199695","21435","9.7","7.9"
"HAMPDEN COUNTY","2010","June","221436","199684","21752","9.8","8.1"
"HAMPDEN COUNTY","2010","July","221143","199016","22127","10.0","8.1"
"HAMPDEN COUNTY","2010","August","220236","198856","21380","9.7","7.7"
"HAMPDEN COUNTY","2010","September","219236","198458","20778","9.5","7.8"
"HAMPDEN COUNTY","2010","October","220890","201176","19714","8.9","7.3"
"HAMPDEN COUNTY","2010","November","221535","201039","20496","9.3","7.5"
"HAMPDEN COUNTY","2010","December","221341","200623","20718","9.4","7.4"
"HAMPDEN COUNTY","2010","Annual","220874","198838","22036","10.0","8.1"
"HAMPDEN COUNTY","2009","January","226843","205327","21516","9.5","7.8"
"HAMPDEN COUNTY","2009","February","227336","206450","20886","9.2","8.1"
"HAMPDEN COUNTY","2009","March","227835","207506","20329","8.9","8.1"
"HAMPDEN COUNTY","2009","April","227152","208309","18843","8.3","7.5"
"HAMPDEN COUNTY","2009","May","226432","206762","19670","8.7","8.0"
"HAMPDEN COUNTY","2009","June","228695","207459","21236","9.3","8.4"
"HAMPDEN COUNTY","2009","July","227110","205220","21890","9.6","8.5"
"HAMPDEN COUNTY","2009","August","225985","204551","21434","9.5","8.2"
"HAMPDEN COUNTY","2009","September","224951","203233","21718","9.7","8.4"
"HAMPDEN COUNTY","2009","October","227049","205277","21772","9.6","8.1"
"HAMPDEN COUNTY","2009","November","227262","205646","21616","9.5","7.9"
"HAMPDEN COUNTY","2009","December","226141","203509","22632","10.0","8.2"
"HAMPDEN COUNTY","2009","Annual","226900","205771","21129","9.3","8.1"
"HAMPDEN COUNTY","2008","January","222620","207443","15177","6.8","5.2"
"HAMPDEN COUNTY","2008","February","222816","208690","14126","6.3","5.1"
"HAMPDEN COUNTY","2008","March","224450","210658","13792","6.1","4.9"
"HAMPDEN COUNTY","2008","April","224409","212103","12306","5.5","4.4"
"HAMPDEN COUNTY","2008","May","224054","210806","13248","5.9","4.9"
"HAMPDEN COUNTY","2008","June","226222","211393","14829","6.6","5.3"
"HAMPDEN COUNTY","2008","July","224820","208823","15997","7.1","5.5"
"HAMPDEN COUNTY","2008","August","224092","208324","15768","7.0","5.4"
"HAMPDEN COUNTY","2008","September","224437","208803","15634","7.0","5.5"
"HAMPDEN COUNTY","2008","October","226889","211359","15530","6.8","5.4"
"HAMPDEN COUNTY","2008","November","226874","210502","16372","7.2","5.7"
"HAMPDEN COUNTY","2008","December","226905","209206","17699","7.8","6.3"
"HAMPDEN COUNTY","2008","Annual","224883","209843","15040","6.7","5.3"
"HAMPDEN COUNTY","2007","January","224381","208656","15725","7.0","5.4"
"HAMPDEN COUNTY","2007","February","223936","209650","14286","6.4","5.1"
"HAMPDEN COUNTY","2007","March","224564","211173","13391","6.0","4.7"
"HAMPDEN COUNTY","2007","April","223502","211257","12245","5.5","4.3"
"HAMPDEN COUNTY","2007","May","223294","211396","11898","5.3","4.3"
"HAMPDEN COUNTY","2007","June","225504","212266","13238","5.9","4.6"
"HAMPDEN COUNTY","2007","July","223564","210128","13436","6.0","4.7"
"HAMPDEN COUNTY","2007","August","221426","209199","12227","5.5","4.3"
"HAMPDEN COUNTY","2007","September","221922","209817","12105","5.5","4.4"
"HAMPDEN COUNTY","2007","October","223076","212094","10982","4.9","4.0"
"HAMPDEN COUNTY","2007","November","224840","213320","11520","5.1","4.0"
"HAMPDEN COUNTY","2007","December","224373","212174","12199","5.4","4.3"
"HAMPDEN COUNTY","2007","Annual","223699","210928","12771","5.7","4.5"
"HAMPDEN COUNTY","2006","January","223099","207622","15477","6.9","5.3"
"HAMPDEN COUNTY","2006","February","224346","209361","14985","6.7","5.3"
"HAMPDEN COUNTY","2006","March","224864","210473","14391","6.4","5.0"
"HAMPDEN COUNTY","2006","April","225267","211899","13368","5.9","4.6"
"HAMPDEN COUNTY","2006","May","224842","211896","12946","5.8","4.6"
"HAMPDEN COUNTY","2006","June","226674","212943","13731","6.1","4.8"
"HAMPDEN COUNTY","2006","July","224886","210544","14342","6.4","5.0"
"HAMPDEN COUNTY","2006","August","223781","210488","13293","5.9","4.6"
"HAMPDEN COUNTY","2006","September","223942","210625","13317","5.9","4.7"
"HAMPDEN COUNTY","2006","October","225427","213736","11691","5.2","4.1"
"HAMPDEN COUNTY","2006","November","226640","214134","12506","5.5","4.3"
"HAMPDEN COUNTY","2006","December","226607","213850","12757","5.6","4.3"
"HAMPDEN COUNTY","2006","Annual","225031","211464","13567","6.0","4.7"
"HAMPDEN COUNTY","2005","January","223379","208307","15072","6.7","5.5"
"HAMPDEN COUNTY","2005","February","223805","209593","14212","6.4","5.5"
"HAMPDEN COUNTY","2005","March","223983","210490","13493","6.0","5.1"
"HAMPDEN COUNTY","2005","April","223643","211389","12254","5.5","4.6"
"HAMPDEN COUNTY","2005","May","223721","211519","12202","5.5","4.7"
"HAMPDEN COUNTY","2005","June","225826","212447","13379","5.9","4.9"
"HAMPDEN COUNTY","2005","July","224073","210445","13628","6.1","4.9"
"HAMPDEN COUNTY","2005","August","223255","210927","12328","5.5","4.5"
"HAMPDEN COUNTY","2005","September","223428","210228","13200","5.9","4.8"
"HAMPDEN COUNTY","2005","October","224734","212865","11869","5.3","4.3"
"HAMPDEN COUNTY","2005","November","225288","212700","12588","5.6","4.5"
"HAMPDEN COUNTY","2005","December","224779","212226","12553","5.6","4.5"
"HAMPDEN COUNTY","2005","Annual","224160","211095","13065","5.8","4.8"
"HAMPDEN COUNTY","2004","January","226240","209406","16834","7.4","6.1"
"HAMPDEN COUNTY","2004","February","225611","210250","15361","6.8","5.8"
"HAMPDEN COUNTY","2004","March","226353","211132","15221","6.7","5.7"
"HAMPDEN COUNTY","2004","April","225050","211695","13355","5.9","5.0"
"HAMPDEN COUNTY","2004","May","224950","211511","13439","6.0","5.0"
"HAMPDEN COUNTY","2004","June","227577","212848","14729","6.5","5.4"
"HAMPDEN COUNTY","2004","July","225682","211099","14583","6.5","5.3"
"HAMPDEN COUNTY","2004","August","223784","210931","12853","5.7","4.8"
"HAMPDEN COUNTY","2004","September","222835","209824","13011","5.8","4.8"
"HAMPDEN COUNTY","2004","October","224290","212692","11598","5.2","4.4"
"HAMPDEN COUNTY","2004","November","225064","213401","11663","5.2","4.5"
"HAMPDEN COUNTY","2004","December","224703","212579","12124","5.4","4.5"
"HAMPDEN COUNTY","2004","Annual","225178","211447","13731","6.1","5.1"
"HAMPDEN COUNTY","2003","January","225740","209136","16604","7.4","6.3"
"HAMPDEN COUNTY","2003","February","225804","210403","15401","6.8","6.1"
"HAMPDEN COUNTY","2003","March","225950","210713","15237","6.7","6.0"
"HAMPDEN COUNTY","2003","April","225659","211621","14038","6.2","5.5"
"HAMPDEN COUNTY","2003","May","225183","211600","13583","6.0","5.7"
"HAMPDEN COUNTY","2003","June","228048","212924","15124","6.6","6.2"
"HAMPDEN COUNTY","2003","July","225623","210477","15146","6.7","6.0"
"HAMPDEN COUNTY","2003","August","225372","211203","14169","6.3","5.6"
"HAMPDEN COUNTY","2003","September","224051","209660","14391","6.4","5.7"
"HAMPDEN COUNTY","2003","October","225350","211823","13527","6.0","5.2"
"HAMPDEN COUNTY","2003","November","226572","212668","13904","6.1","5.2"
"HAMPDEN COUNTY","2003","December","226505","212815","13690","6.0","5.1"
"HAMPDEN COUNTY","2003","Annual","225822","211254","14568","6.5","5.7"
"HAMPDEN COUNTY","2002","January","222390","208931","13459","6.1","5.6"
"HAMPDEN COUNTY","2002","February","224397","211491","12906","5.8","5.4"
"HAMPDEN COUNTY","2002","March","224806","211900","12906","5.7","5.4"
"HAMPDEN COUNTY","2002","April","223567","211601","11966","5.4","5.0"
"HAMPDEN COUNTY","2002","May","224391","212681","11710","5.2","4.9"
"HAMPDEN COUNTY","2002","June","227428","214048","13380","5.9","5.4"
"HAMPDEN COUNTY","2002","July","225897","212207","13690","6.1","5.4"
"HAMPDEN COUNTY","2002","August","224100","211263","12837","5.7","5.1"
"HAMPDEN COUNTY","2002","September","225389","212591","12798","5.7","5.2"
"HAMPDEN COUNTY","2002","October","225909","213605","12304","5.4","4.9"
"HAMPDEN COUNTY","2002","November","226144","213200","12944","5.7","5.1"
"HAMPDEN COUNTY","2002","December","226177","212840","13337","5.9","5.3"
"HAMPDEN COUNTY","2002","Annual","225050","212197","12853","5.7","5.2"
"HAMPDEN COUNTY","2001","January","219323","208885","10438","4.8","3.7"
"HAMPDEN COUNTY","2001","February","219419","209556","9863","4.5","3.5"
"HAMPDEN COUNTY","2001","March","220609","210690","9919","4.5","3.6"
"HAMPDEN COUNTY","2001","April","218879","210208","8671","4.0","3.2"
"HAMPDEN COUNTY","2001","May","219000","210704","8296","3.8","3.3"
"HAMPDEN COUNTY","2001","June","221655","212126","9529","4.3","3.8"
"HAMPDEN COUNTY","2001","July","220301","210653","9648","4.4","3.9"
"HAMPDEN COUNTY","2001","August","219669","210397","9272","4.2","3.9"
"HAMPDEN COUNTY","2001","September","219813","210697","9116","4.1","4.0"
"HAMPDEN COUNTY","2001","October","221189","212814","8375","3.8","4.0"
"HAMPDEN COUNTY","2001","November","222622","213496","9126","4.1","4.2"
"HAMPDEN COUNTY","2001","December","223182","213419","9763","4.4","4.4"
"HAMPDEN COUNTY","2001","Annual","220472","211137","9335","4.2","3.8"
"HAMPSHIRE COUNTY","2020","January","90930","87990","2940","3.2","3.5"
"HAMPSHIRE COUNTY","2020","February","91424","88664","2760","3.0","3.3"
"HAMPSHIRE COUNTY","2020","March","90178","87377","2801","3.1","3.6"
"HAMPSHIRE COUNTY","2020","April","79510","69335","10175","12.8","16.7"
"HAMPSHIRE COUNTY","2020","May","84792","74843","9949","11.7","15.6"
"HAMPSHIRE COUNTY","2020","June","88345","77921","10424","11.8","14.5"
"HAMPSHIRE COUNTY","2020","July","88391","79028","9363","10.6","13.0"
"HAMPSHIRE COUNTY","2020","August","88388","81222","7166","8.1","10.3"
"HAMPSHIRE COUNTY","2020","September","87850","81136","6714","7.6","9.8"
"HAMPSHIRE COUNTY","2020","October","89940","83838","6102","6.8","8.1"
"HAMPSHIRE COUNTY","2020","November","90229","84180","6049","6.7","7.6"
"HAMPSHIRE COUNTY","2020","December","90340","84172","6168","6.8","7.4"
"HAMPSHIRE COUNTY","2020","Annual","88360","81642","6718","7.6","9.4"
"HAMPSHIRE COUNTY","2019","January","91694","88382","3312","3.6","4.0"
"HAMPSHIRE COUNTY","2019","February","92256","89257","2999","3.3","3.6"
"HAMPSHIRE COUNTY","2019","March","92221","89310","2911","3.2","3.4"
"HAMPSHIRE COUNTY","2019","April","91825","89547","2278","2.5","2.8"
"HAMPSHIRE COUNTY","2019","May","91837","89358","2479","2.7","2.9"
"HAMPSHIRE COUNTY","2019","June","91513","88600","2913","3.2","3.2"
"HAMPSHIRE COUNTY","2019","July","91260","88167","3093","3.4","3.3"
"HAMPSHIRE COUNTY","2019","August","90818","88204","2614","2.9","3.0"
"HAMPSHIRE COUNTY","2019","September","91221","88709","2512","2.8","2.8"
"HAMPSHIRE COUNTY","2019","October","91588","89408","2180","2.4","2.6"
"HAMPSHIRE COUNTY","2019","November","91590","89603","1987","2.2","2.5"
"HAMPSHIRE COUNTY","2019","December","91395","89387","2008","2.2","2.6"
"HAMPSHIRE COUNTY","2019","Annual","91601","88994","2607","2.8","3.1"
"HAMPSHIRE COUNTY","2018","January","89368","86114","3254","3.6","4.3"
"HAMPSHIRE COUNTY","2018","February","90659","87391","3268","3.6","4.2"
"HAMPSHIRE COUNTY","2018","March","91063","87920","3143","3.5","3.8"
"HAMPSHIRE COUNTY","2018","April","91238","88563","2675","2.9","3.3"
"HAMPSHIRE COUNTY","2018","May","90871","88226","2645","2.9","3.3"
"HAMPSHIRE COUNTY","2018","June","91987","88530","3457","3.8","3.7"
"HAMPSHIRE COUNTY","2018","July","91533","88180","3353","3.7","3.7"
"HAMPSHIRE COUNTY","2018","August","91147","88326","2821","3.1","3.3"
"HAMPSHIRE COUNTY","2018","September","91524","88903","2621","2.9","3.2"
"HAMPSHIRE COUNTY","2018","October","91977","89626","2351","2.6","2.9"
"HAMPSHIRE COUNTY","2018","November","92356","90143","2213","2.4","2.8"
"HAMPSHIRE COUNTY","2018","December","92246","89831","2415","2.6","3.0"
"HAMPSHIRE COUNTY","2018","Annual","91330","88479","2851","3.1","3.4"
"HAMPSHIRE COUNTY","2017","January","88617","84962","3655","4.1","4.5"
"HAMPSHIRE COUNTY","2017","February","89673","86143","3530","3.9","4.4"
"HAMPSHIRE COUNTY","2017","March","90210","86807","3403","3.8","4.0"
"HAMPSHIRE COUNTY","2017","April","90263","87341","2922","3.2","3.6"
"HAMPSHIRE COUNTY","2017","May","89695","86686","3009","3.4","3.7"
"HAMPSHIRE COUNTY","2017","June","90533","86862","3671","4.1","4.0"
"HAMPSHIRE COUNTY","2017","July","90282","86429","3853","4.3","4.1"
"HAMPSHIRE COUNTY","2017","August","89787","86523","3264","3.6","3.8"
"HAMPSHIRE COUNTY","2017","September","89757","86768","2989","3.3","3.7"
"HAMPSHIRE COUNTY","2017","October","90111","87482","2629","2.9","3.3"
"HAMPSHIRE COUNTY","2017","November","90411","87864","2547","2.8","3.3"
"HAMPSHIRE COUNTY","2017","December","90395","87835","2560","2.8","3.4"
"HAMPSHIRE COUNTY","2017","Annual","89978","86809","3169","3.5","3.8"
"HAMPSHIRE COUNTY","2016","January","87055","83215","3840","4.4","4.9"
"HAMPSHIRE COUNTY","2016","February","88071","84370","3701","4.2","4.7"
"HAMPSHIRE COUNTY","2016","March","88549","84954","3595","4.1","4.5"
"HAMPSHIRE COUNTY","2016","April","88308","85165","3143","3.6","3.9"
"HAMPSHIRE COUNTY","2016","May","87717","84405","3312","3.8","3.9"
"HAMPSHIRE COUNTY","2016","June","88399","84494","3905","4.4","4.2"
"HAMPSHIRE COUNTY","2016","July","88385","84602","3783","4.3","4.2"
"HAMPSHIRE COUNTY","2016","August","88050","84729","3321","3.8","3.8"
"HAMPSHIRE COUNTY","2016","September","87671","84571","3100","3.5","3.8"
"HAMPSHIRE COUNTY","2016","October","88182","85444","2738","3.1","3.5"
"HAMPSHIRE COUNTY","2016","November","88298","85696","2602","2.9","3.3"
"HAMPSHIRE COUNTY","2016","December","88263","85563","2700","3.1","3.5"
"HAMPSHIRE COUNTY","2016","Annual","88079","84767","3312","3.8","4.0"
"HAMPSHIRE COUNTY","2015","January","87268","82540","4728","5.4","5.8"
"HAMPSHIRE COUNTY","2015","February","87862","83555","4307","4.9","5.5"
"HAMPSHIRE COUNTY","2015","March","87752","83637","4115","4.7","5.2"
"HAMPSHIRE COUNTY","2015","April","87907","84153","3754","4.3","4.6"
"HAMPSHIRE COUNTY","2015","May","87859","83870","3989","4.5","4.9"
"HAMPSHIRE COUNTY","2015","June","88526","84066","4460","5.0","5.0"
"HAMPSHIRE COUNTY","2015","July","87411","82985","4426","5.1","5.0"
"HAMPSHIRE COUNTY","2015","August","86856","83051","3805","4.4","4.5"
"HAMPSHIRE COUNTY","2015","September","85858","82229","3629","4.2","4.5"
"HAMPSHIRE COUNTY","2015","October","86948","83655","3293","3.8","4.2"
"HAMPSHIRE COUNTY","2015","November","87128","83793","3335","3.8","4.1"
"HAMPSHIRE COUNTY","2015","December","87128","83814","3314","3.8","4.1"
"HAMPSHIRE COUNTY","2015","Annual","87376","83446","3930","4.5","4.8"
"HAMPSHIRE COUNTY","2014","January","85627","80370","5257","6.1","6.7"
"HAMPSHIRE COUNTY","2014","February","86358","81304","5054","5.9","6.7"
"HAMPSHIRE COUNTY","2014","March","86955","82059","4896","5.6","6.4"
"HAMPSHIRE COUNTY","2014","April","87083","82775","4308","4.9","5.5"
"HAMPSHIRE COUNTY","2014","May","86997","82415","4582","5.3","5.7"
"HAMPSHIRE COUNTY","2014","June","87609","82548","5061","5.8","5.9"
"HAMPSHIRE COUNTY","2014","July","87335","82274","5061","5.8","6.1"
"HAMPSHIRE COUNTY","2014","August","86991","82513","4478","5.1","5.7"
"HAMPSHIRE COUNTY","2014","September","86387","82048","4339","5.0","5.5"
"HAMPSHIRE COUNTY","2014","October","87848","83847","4001","4.6","5.0"
"HAMPSHIRE COUNTY","2014","November","87929","83894","4035","4.6","4.9"
"HAMPSHIRE COUNTY","2014","December","87716","83856","3860","4.4","4.8"
"HAMPSHIRE COUNTY","2014","Annual","87070","82492","4578","5.3","5.7"
"HAMPSHIRE COUNTY","2013","January","84825","79124","5701","6.7","7.6"
"HAMPSHIRE COUNTY","2013","February","85211","79962","5249","6.2","7.2"
"HAMPSHIRE COUNTY","2013","March","85334","80397","4937","5.8","6.9"
"HAMPSHIRE COUNTY","2013","April","86044","81193","4851","5.6","6.3"
"HAMPSHIRE COUNTY","2013","May","85966","80688","5278","6.1","6.6"
"HAMPSHIRE COUNTY","2013","June","86496","80504","5992","6.9","7.1"
"HAMPSHIRE COUNTY","2013","July","85610","79898","5712","6.7","7.0"
"HAMPSHIRE COUNTY","2013","August","85196","80072","5124","6.0","6.5"
"HAMPSHIRE COUNTY","2013","September","85301","80333","4968","5.8","6.5"
"HAMPSHIRE COUNTY","2013","October","85239","80551","4688","5.5","6.2"
"HAMPSHIRE COUNTY","2013","November","85365","80903","4462","5.2","5.9"
"HAMPSHIRE COUNTY","2013","December","85648","81192","4456","5.2","5.9"
"HAMPSHIRE COUNTY","2013","Annual","85519","80401","5118","6.0","6.6"
"HAMPSHIRE COUNTY","2012","January","84695","79288","5407","6.4","7.4"
"HAMPSHIRE COUNTY","2012","February","85267","80129","5138","6.0","7.3"
"HAMPSHIRE COUNTY","2012","March","85943","81256","4687","5.5","6.9"
"HAMPSHIRE COUNTY","2012","April","86176","81717","4459","5.2","6.3"
"HAMPSHIRE COUNTY","2012","May","86202","81518","4684","5.4","6.5"
"HAMPSHIRE COUNTY","2012","June","87433","81732","5701","6.5","6.9"
"HAMPSHIRE COUNTY","2012","July","85824","79980","5844","6.8","7.1"
"HAMPSHIRE COUNTY","2012","August","85252","80097","5155","6.0","6.7"
"HAMPSHIRE COUNTY","2012","September","85434","80527","4907","5.7","6.5"
"HAMPSHIRE COUNTY","2012","October","86171","81472","4699","5.5","6.3"
"HAMPSHIRE COUNTY","2012","November","85594","81047","4547","5.3","6.1"
"HAMPSHIRE COUNTY","2012","December","85449","80678","4771","5.6","6.4"
"HAMPSHIRE COUNTY","2012","Annual","85787","80787","5000","5.8","6.7"
"HAMPSHIRE COUNTY","2011","January","84817","78873","5944","7.0","8.3"
"HAMPSHIRE COUNTY","2011","February","85093","79602","5491","6.5","8.0"
"HAMPSHIRE COUNTY","2011","March","85361","80197","5164","6.0","7.6"
"HAMPSHIRE COUNTY","2011","April","85637","80582","5055","5.9","7.0"
"HAMPSHIRE COUNTY","2011","May","85182","80164","5018","5.9","7.1"
"HAMPSHIRE COUNTY","2011","June","86260","80302","5958","6.9","7.5"
"HAMPSHIRE COUNTY","2011","July","85461","79484","5977","7.0","7.5"
"HAMPSHIRE COUNTY","2011","August","85098","79821","5277","6.2","7.0"
"HAMPSHIRE COUNTY","2011","September","85263","80151","5112","6.0","7.1"
"HAMPSHIRE COUNTY","2011","October","85608","80815","4793","5.6","6.6"
"HAMPSHIRE COUNTY","2011","November","85094","80564","4530","5.3","6.4"
"HAMPSHIRE COUNTY","2011","December","85296","80661","4635","5.4","6.5"
"HAMPSHIRE COUNTY","2011","Annual","85347","80101","5246","6.1","7.2"
"HAMPSHIRE COUNTY","2010","January","84249","77772","6477","7.7","9.3"
"HAMPSHIRE COUNTY","2010","February","84613","78593","6020","7.1","9.1"
"HAMPSHIRE COUNTY","2010","March","85150","79359","5791","6.8","8.7"
"HAMPSHIRE COUNTY","2010","April","85572","80212","5360","6.3","8.0"
"HAMPSHIRE COUNTY","2010","May","85677","80130","5547","6.5","7.9"
"HAMPSHIRE COUNTY","2010","June","86546","80130","6416","7.4","8.1"
"HAMPSHIRE COUNTY","2010","July","86397","79871","6526","7.6","8.1"
"HAMPSHIRE COUNTY","2010","August","85645","79794","5851","6.8","7.7"
"HAMPSHIRE COUNTY","2010","September","85414","79631","5783","6.8","7.8"
"HAMPSHIRE COUNTY","2010","October","85927","80710","5217","6.1","7.3"
"HAMPSHIRE COUNTY","2010","November","86018","80644","5374","6.2","7.5"
"HAMPSHIRE COUNTY","2010","December","85924","80482","5442","6.3","7.4"
"HAMPSHIRE COUNTY","2010","Annual","85594","79777","5817","6.8","8.1"
"HAMPSHIRE COUNTY","2009","January","85726","80372","5354","6.2","7.8"
"HAMPSHIRE COUNTY","2009","February","88554","83177","5377","6.1","8.1"
"HAMPSHIRE COUNTY","2009","March","88434","83407","5027","5.7","8.1"
"HAMPSHIRE COUNTY","2009","April","88589","83926","4663","5.3","7.5"
"HAMPSHIRE COUNTY","2009","May","88604","83396","5208","5.9","8.0"
"HAMPSHIRE COUNTY","2009","June","86495","80311","6184","7.1","8.4"
"HAMPSHIRE COUNTY","2009","July","85754","79412","6342","7.4","8.5"
"HAMPSHIRE COUNTY","2009","August","84902","79133","5769","6.8","8.2"
"HAMPSHIRE COUNTY","2009","September","86907","80780","6127","7.1","8.4"
"HAMPSHIRE COUNTY","2009","October","88537","82788","5749","6.5","8.1"
"HAMPSHIRE COUNTY","2009","November","88976","83045","5931","6.7","7.9"
"HAMPSHIRE COUNTY","2009","December","87710","81797","5913","6.7","8.2"
"HAMPSHIRE COUNTY","2009","Annual","87432","81795","5637","6.4","8.1"
"HAMPSHIRE COUNTY","2008","January","86095","82170","3925","4.6","5.2"
"HAMPSHIRE COUNTY","2008","February","88928","85242","3686","4.1","5.1"
"HAMPSHIRE COUNTY","2008","March","89536","85921","3615","4.0","4.9"
"HAMPSHIRE COUNTY","2008","April","89566","86357","3209","3.6","4.4"
"HAMPSHIRE COUNTY","2008","May","89673","85905","3768","4.2","4.9"
"HAMPSHIRE COUNTY","2008","June","87192","82763","4429","5.1","5.3"
"HAMPSHIRE COUNTY","2008","July","86253","81758","4495","5.2","5.5"
"HAMPSHIRE COUNTY","2008","August","85510","81471","4039","4.7","5.4"
"HAMPSHIRE COUNTY","2008","September","88084","83949","4135","4.7","5.5"
"HAMPSHIRE COUNTY","2008","October","90150","86186","3964","4.4","5.4"
"HAMPSHIRE COUNTY","2008","November","90340","85919","4421","4.9","5.7"
"HAMPSHIRE COUNTY","2008","December","89595","85039","4556","5.1","6.3"
"HAMPSHIRE COUNTY","2008","Annual","88410","84390","4020","4.5","5.3"
"HAMPSHIRE COUNTY","2007","January","86700","82660","4040","4.7","5.4"
"HAMPSHIRE COUNTY","2007","February","89438","85616","3822","4.3","5.1"
"HAMPSHIRE COUNTY","2007","March","89671","86215","3456","3.9","4.7"
"HAMPSHIRE COUNTY","2007","April","89381","86141","3240","3.6","4.3"
"HAMPSHIRE COUNTY","2007","May","89532","86225","3307","3.7","4.3"
"HAMPSHIRE COUNTY","2007","June","87288","83392","3896","4.5","4.6"
"HAMPSHIRE COUNTY","2007","July","86143","82313","3830","4.4","4.7"
"HAMPSHIRE COUNTY","2007","August","85049","81952","3097","3.6","4.3"
"HAMPSHIRE COUNTY","2007","September","87664","84448","3216","3.7","4.4"
"HAMPSHIRE COUNTY","2007","October","89446","86474","2972","3.3","4.0"
"HAMPSHIRE COUNTY","2007","November","90029","87019","3010","3.3","4.0"
"HAMPSHIRE COUNTY","2007","December","89252","86087","3165","3.5","4.3"
"HAMPSHIRE COUNTY","2007","Annual","88300","84879","3421","3.9","4.5"
"HAMPSHIRE COUNTY","2006","January","85850","82021","3829","4.5","5.3"
"HAMPSHIRE COUNTY","2006","February","89136","85195","3941","4.4","5.3"
"HAMPSHIRE COUNTY","2006","March","89178","85588","3590","4.0","5.0"
"HAMPSHIRE COUNTY","2006","April","89330","86015","3315","3.7","4.6"
"HAMPSHIRE COUNTY","2006","May","89436","86091","3345","3.7","4.6"
"HAMPSHIRE COUNTY","2006","June","87406","83473","3933","4.5","4.8"
"HAMPSHIRE COUNTY","2006","July","86133","82116","4017","4.7","5.0"
"HAMPSHIRE COUNTY","2006","August","85581","82060","3521","4.1","4.6"
"HAMPSHIRE COUNTY","2006","September","87972","84338","3634","4.1","4.7"
"HAMPSHIRE COUNTY","2006","October","90107","86820","3287","3.6","4.1"
"HAMPSHIRE COUNTY","2006","November","90447","86998","3449","3.8","4.3"
"HAMPSHIRE COUNTY","2006","December","89681","86511","3170","3.5","4.3"
"HAMPSHIRE COUNTY","2006","Annual","88355","84769","3586","4.1","4.7"
"HAMPSHIRE COUNTY","2005","January","85666","81870","3796","4.4","5.5"
"HAMPSHIRE COUNTY","2005","February","88748","84939","3809","4.3","5.5"
"HAMPSHIRE COUNTY","2005","March","88932","85286","3646","4.1","5.1"
"HAMPSHIRE COUNTY","2005","April","89086","85609","3477","3.9","4.6"
"HAMPSHIRE COUNTY","2005","May","89150","85667","3483","3.9","4.7"
"HAMPSHIRE COUNTY","2005","June","86693","82786","3907","4.5","4.9"
"HAMPSHIRE COUNTY","2005","July","85554","81777","3777","4.4","4.9"
"HAMPSHIRE COUNTY","2005","August","85146","81835","3311","3.9","4.5"
"HAMPSHIRE COUNTY","2005","September","87151","83746","3405","3.9","4.8"
"HAMPSHIRE COUNTY","2005","October","89430","86171","3259","3.6","4.3"
"HAMPSHIRE COUNTY","2005","November","89626","86046","3580","4.0","4.5"
"HAMPSHIRE COUNTY","2005","December","88684","85457","3227","3.6","4.5"
"HAMPSHIRE COUNTY","2005","Annual","87822","84266","3556","4.0","4.8"
"HAMPSHIRE COUNTY","2004","January","86672","82454","4218","4.9","6.1"
"HAMPSHIRE COUNTY","2004","February","89288","85338","3950","4.4","5.8"
"HAMPSHIRE COUNTY","2004","March","89631","85731","3900","4.4","5.7"
"HAMPSHIRE COUNTY","2004","April","89261","85771","3490","3.9","5.0"
"HAMPSHIRE COUNTY","2004","May","89345","85805","3540","4.0","5.0"
"HAMPSHIRE COUNTY","2004","June","87071","83012","4059","4.7","5.4"
"HAMPSHIRE COUNTY","2004","July","86403","82394","4009","4.6","5.3"
"HAMPSHIRE COUNTY","2004","August","85548","82145","3403","4.0","4.8"
"HAMPSHIRE COUNTY","2004","September","87209","83939","3270","3.7","4.8"
"HAMPSHIRE COUNTY","2004","October","89327","86287","3040","3.4","4.4"
"HAMPSHIRE COUNTY","2004","November","89816","86707","3109","3.5","4.5"
"HAMPSHIRE COUNTY","2004","December","88822","85808","3014","3.4","4.5"
"HAMPSHIRE COUNTY","2004","Annual","88200","84616","3584","4.1","5.1"
"HAMPSHIRE COUNTY","2003","January","86241","82212","4029","4.7","6.3"
"HAMPSHIRE COUNTY","2003","February","89172","85279","3893","4.4","6.1"
"HAMPSHIRE COUNTY","2003","March","89120","85360","3760","4.2","6.0"
"HAMPSHIRE COUNTY","2003","April","89218","85681","3537","4.0","5.5"
"HAMPSHIRE COUNTY","2003","May","89274","85745","3529","4.0","5.7"
"HAMPSHIRE COUNTY","2003","June","87276","83250","4026","4.6","6.2"
"HAMPSHIRE COUNTY","2003","July","86196","82301","3895","4.5","6.0"
"HAMPSHIRE COUNTY","2003","August","85963","82393","3570","4.2","5.6"
"HAMPSHIRE COUNTY","2003","September","87762","84005","3757","4.3","5.7"
"HAMPSHIRE COUNTY","2003","October","89147","85774","3373","3.8","5.2"
"HAMPSHIRE COUNTY","2003","November","89510","86095","3415","3.8","5.2"
"HAMPSHIRE COUNTY","2003","December","89181","85845","3336","3.7","5.1"
"HAMPSHIRE COUNTY","2003","Annual","88172","84495","3677","4.2","5.7"
"HAMPSHIRE COUNTY","2002","January","84865","81684","3181","3.7","5.6"
"HAMPSHIRE COUNTY","2002","February","88222","85112","3110","3.5","5.4"
"HAMPSHIRE COUNTY","2002","March","88338","85221","3117","3.5","5.4"
"HAMPSHIRE COUNTY","2002","April","87942","85080","2862","3.3","5.0"
"HAMPSHIRE COUNTY","2002","May","88340","85514","2826","3.2","4.9"
"HAMPSHIRE COUNTY","2002","June","86402","83019","3383","3.9","5.4"
"HAMPSHIRE COUNTY","2002","July","85678","82240","3438","4.0","5.4"
"HAMPSHIRE COUNTY","2002","August","84827","81734","3093","3.6","5.1"
"HAMPSHIRE COUNTY","2002","September","87615","84456","3159","3.6","5.2"
"HAMPSHIRE COUNTY","2002","October","88777","85885","2892","3.3","4.9"
"HAMPSHIRE COUNTY","2002","November","88790","85706","3084","3.5","5.1"
"HAMPSHIRE COUNTY","2002","December","88421","85225","3196","3.6","5.3"
"HAMPSHIRE COUNTY","2002","Annual","87352","84240","3112","3.6","5.2"
"HAMPSHIRE COUNTY","2001","January","84149","81494","2655","3.2","3.7"
"HAMPSHIRE COUNTY","2001","February","86539","84094","2445","2.8","3.5"
"HAMPSHIRE COUNTY","2001","March","87119","84598","2521","2.9","3.6"
"HAMPSHIRE COUNTY","2001","April","86552","84420","2132","2.5","3.2"
"HAMPSHIRE COUNTY","2001","May","86614","84525","2089","2.4","3.3"
"HAMPSHIRE COUNTY","2001","June","84536","82059","2477","2.9","3.8"
"HAMPSHIRE COUNTY","2001","July","84049","81547","2502","3.0","3.9"
"HAMPSHIRE COUNTY","2001","August","83468","81264","2204","2.6","3.9"
"HAMPSHIRE COUNTY","2001","September","85743","83437","2306","2.7","4.0"
"HAMPSHIRE COUNTY","2001","October","87482","85385","2097","2.4","4.0"
"HAMPSHIRE COUNTY","2001","November","87825","85563","2262","2.6","4.2"
"HAMPSHIRE COUNTY","2001","December","87601","85187","2414","2.8","4.4"
"HAMPSHIRE COUNTY","2001","Annual","85973","83631","2342","2.7","3.8"
"MIDDLESEX COUNTY","2020","January","928695","903792","24903","2.7","3.5"
"MIDDLESEX COUNTY","2020","February","929024","906339","22685","2.4","3.3"
"MIDDLESEX COUNTY","2020","March","915568","890682","24886","2.7","3.6"
"MIDDLESEX COUNTY","2020","April","820044","711121","108923","13.3","16.7"
"MIDDLESEX COUNTY","2020","May","869483","758534","110949","12.8","15.6"
"MIDDLESEX COUNTY","2020","June","903454","794286","109168","12.1","14.5"
"MIDDLESEX COUNTY","2020","July","910150","810804","99346","10.9","13.0"
"MIDDLESEX COUNTY","2020","August","911490","832795","78695","8.6","10.3"
"MIDDLESEX COUNTY","2020","September","901202","827093","74109","8.2","9.8"
"MIDDLESEX COUNTY","2020","October","910053","845389","64664","7.1","8.1"
"MIDDLESEX COUNTY","2020","November","908005","847688","60317","6.6","7.6"
"MIDDLESEX COUNTY","2020","December","904571","848426","56145","6.2","7.4"
"MIDDLESEX COUNTY","2020","Annual","900978","831412","69566","7.7","9.4"
"MIDDLESEX COUNTY","2019","January","930547","902498","28049","3.0","4.0"
"MIDDLESEX COUNTY","2019","February","931451","906104","25347","2.7","3.6"
"MIDDLESEX COUNTY","2019","March","932298","907895","24403","2.6","3.4"
"MIDDLESEX COUNTY","2019","April","928029","907695","20334","2.2","2.8"
"MIDDLESEX COUNTY","2019","May","927487","905021","22466","2.4","2.9"
"MIDDLESEX COUNTY","2019","June","940794","915929","24865","2.6","3.2"
"MIDDLESEX COUNTY","2019","July","941719","915861","25858","2.7","3.3"
"MIDDLESEX COUNTY","2019","August","940101","917043","23058","2.5","3.0"
"MIDDLESEX COUNTY","2019","September","924903","903200","21703","2.3","2.8"
"MIDDLESEX COUNTY","2019","October","931740","912092","19648","2.1","2.6"
"MIDDLESEX COUNTY","2019","November","932499","913817","18682","2.0","2.5"
"MIDDLESEX COUNTY","2019","December","930349","912107","18242","2.0","2.6"
"MIDDLESEX COUNTY","2019","Annual","932660","909939","22721","2.4","3.1"
"MIDDLESEX COUNTY","2018","January","908585","878985","29600","3.3","4.3"
"MIDDLESEX COUNTY","2018","February","916947","887595","29352","3.2","4.2"
"MIDDLESEX COUNTY","2018","March","920107","892808","27299","3.0","3.8"
"MIDDLESEX COUNTY","2018","April","920413","896031","24382","2.6","3.3"
"MIDDLESEX COUNTY","2018","May","921901","896852","25049","2.7","3.3"
"MIDDLESEX COUNTY","2018","June","934764","905213","29551","3.2","3.7"
"MIDDLESEX COUNTY","2018","July","936899","907722","29177","3.1","3.7"
"MIDDLESEX COUNTY","2018","August","929364","903331","26033","2.8","3.3"
"MIDDLESEX COUNTY","2018","September","919649","895125","24524","2.7","3.2"
"MIDDLESEX COUNTY","2018","October","926320","903896","22424","2.4","2.9"
"MIDDLESEX COUNTY","2018","November","927793","907041","20752","2.2","2.8"
"MIDDLESEX COUNTY","2018","December","928156","906469","21687","2.3","3.0"
"MIDDLESEX COUNTY","2018","Annual","924241","898422","25819","2.8","3.4"
"MIDDLESEX COUNTY","2017","January","890450","859525","30925","3.5","4.5"
"MIDDLESEX COUNTY","2017","February","893040","862843","30197","3.4","4.4"
"MIDDLESEX COUNTY","2017","March","898243","870255","27988","3.1","4.0"
"MIDDLESEX COUNTY","2017","April","896914","871009","25905","2.9","3.6"
"MIDDLESEX COUNTY","2017","May","894704","866771","27933","3.1","3.7"
"MIDDLESEX COUNTY","2017","June","908634","877319","31315","3.4","4.0"
"MIDDLESEX COUNTY","2017","July","911988","880091","31897","3.5","4.1"
"MIDDLESEX COUNTY","2017","August","909058","879419","29639","3.3","3.8"
"MIDDLESEX COUNTY","2017","September","898831","870770","28061","3.1","3.7"
"MIDDLESEX COUNTY","2017","October","900276","874844","25432","2.8","3.3"
"MIDDLESEX COUNTY","2017","November","905407","880608","24799","2.7","3.3"
"MIDDLESEX COUNTY","2017","December","905426","880777","24649","2.7","3.4"
"MIDDLESEX COUNTY","2017","Annual","901081","872853","28228","3.1","3.8"
"MIDDLESEX COUNTY","2016","January","861478","828951","32527","3.8","4.9"
"MIDDLESEX COUNTY","2016","February","865752","834079","31673","3.7","4.7"
"MIDDLESEX COUNTY","2016","March","869814","839094","30720","3.5","4.5"
"MIDDLESEX COUNTY","2016","April","869400","841646","27754","3.2","3.9"
"MIDDLESEX COUNTY","2016","May","865627","837634","27993","3.2","3.9"
"MIDDLESEX COUNTY","2016","June","879172","847924","31248","3.6","4.2"
"MIDDLESEX COUNTY","2016","July","886423","855122","31301","3.5","4.2"
"MIDDLESEX COUNTY","2016","August","884108","855695","28413","3.2","3.8"
"MIDDLESEX COUNTY","2016","September","870389","842173","28216","3.2","3.8"
"MIDDLESEX COUNTY","2016","October","875053","849365","25688","2.9","3.5"
"MIDDLESEX COUNTY","2016","November","877671","853612","24059","2.7","3.3"
"MIDDLESEX COUNTY","2016","December","877947","853309","24638","2.8","3.5"
"MIDDLESEX COUNTY","2016","Annual","873570","844884","28686","3.3","4.0"
"MIDDLESEX COUNTY","2015","January","860590","821889","38701","4.5","5.8"
"MIDDLESEX COUNTY","2015","February","859965","823331","36634","4.3","5.5"
"MIDDLESEX COUNTY","2015","March","861318","826893","34425","4.0","5.2"
"MIDDLESEX COUNTY","2015","April","862043","829788","32255","3.7","4.6"
"MIDDLESEX COUNTY","2015","May","864231","828723","35508","4.1","4.9"
"MIDDLESEX COUNTY","2015","June","874197","837091","37106","4.2","5.0"
"MIDDLESEX COUNTY","2015","July","873466","836602","36864","4.2","5.0"
"MIDDLESEX COUNTY","2015","August","869428","836609","32819","3.8","4.5"
"MIDDLESEX COUNTY","2015","September","850707","818299","32408","3.8","4.5"
"MIDDLESEX COUNTY","2015","October","860353","830028","30325","3.5","4.2"
"MIDDLESEX COUNTY","2015","November","863002","833558","29444","3.4","4.1"
"MIDDLESEX COUNTY","2015","December","862394","833639","28755","3.3","4.1"
"MIDDLESEX COUNTY","2015","Annual","863474","829704","33770","3.9","4.8"
"MIDDLESEX COUNTY","2014","January","840345","796229","44116","5.2","6.7"
"MIDDLESEX COUNTY","2014","February","844235","800551","43684","5.2","6.7"
"MIDDLESEX COUNTY","2014","March","849214","807282","41932","4.9","6.4"
"MIDDLESEX COUNTY","2014","April","845000","807756","37244","4.4","5.5"
"MIDDLESEX COUNTY","2014","May","848700","808565","40135","4.7","5.7"
"MIDDLESEX COUNTY","2014","June","863194","820645","42549","4.9","5.9"
"MIDDLESEX COUNTY","2014","July","867436","823386","44050","5.1","6.1"
"MIDDLESEX COUNTY","2014","August","862797","821821","40976","4.7","5.7"
"MIDDLESEX COUNTY","2014","September","852274","812567","39707","4.7","5.5"
"MIDDLESEX COUNTY","2014","October","863433","826911","36522","4.2","5.0"
"MIDDLESEX COUNTY","2014","November","866814","831722","35092","4.0","4.9"
"MIDDLESEX COUNTY","2014","December","862256","829658","32598","3.8","4.8"
"MIDDLESEX COUNTY","2014","Annual","855475","815591","39884","4.7","5.7"
"MIDDLESEX COUNTY","2013","January","836232","786386","49846","6.0","7.6"
"MIDDLESEX COUNTY","2013","February","834320","787521","46799","5.6","7.2"
"MIDDLESEX COUNTY","2013","March","834882","790674","44208","5.3","6.9"
"MIDDLESEX COUNTY","2013","April","835815","793203","42612","5.1","6.3"
"MIDDLESEX COUNTY","2013","May","838127","792231","45896","5.5","6.6"
"MIDDLESEX COUNTY","2013","June","851727","801062","50665","5.9","7.1"
"MIDDLESEX COUNTY","2013","July","853162","803180","49982","5.9","7.0"
"MIDDLESEX COUNTY","2013","August","849594","803571","46023","5.4","6.5"
"MIDDLESEX COUNTY","2013","September","837014","790931","46083","5.5","6.5"
"MIDDLESEX COUNTY","2013","October","837457","793242","44215","5.3","6.2"
"MIDDLESEX COUNTY","2013","November","841173","800815","40358","4.8","5.9"
"MIDDLESEX COUNTY","2013","December","839234","799790","39444","4.7","5.9"
"MIDDLESEX COUNTY","2013","Annual","840728","795217","45511","5.4","6.6"
"MIDDLESEX COUNTY","2012","January","828508","780937","47571","5.7","7.4"
"MIDDLESEX COUNTY","2012","February","830517","783651","46866","5.6","7.3"
"MIDDLESEX COUNTY","2012","March","832908","788527","44381","5.3","6.9"
"MIDDLESEX COUNTY","2012","April","830278","787994","42284","5.1","6.3"
"MIDDLESEX COUNTY","2012","May","831894","787537","44357","5.3","6.5"
"MIDDLESEX COUNTY","2012","June","846297","797382","48915","5.8","6.9"
"MIDDLESEX COUNTY","2012","July","846345","796092","50253","5.9","7.1"
"MIDDLESEX COUNTY","2012","August","843809","797182","46627","5.5","6.7"
"MIDDLESEX COUNTY","2012","September","833327","787717","45610","5.5","6.5"
"MIDDLESEX COUNTY","2012","October","841019","796630","44389","5.3","6.3"
"MIDDLESEX COUNTY","2012","November","839016","797304","41712","5.0","6.1"
"MIDDLESEX COUNTY","2012","December","838003","794635","43368","5.2","6.4"
"MIDDLESEX COUNTY","2012","Annual","836827","791299","45528","5.4","6.7"
"MIDDLESEX COUNTY","2011","January","821585","767660","53925","6.6","8.3"
"MIDDLESEX COUNTY","2011","February","820057","768915","51142","6.2","8.0"
"MIDDLESEX COUNTY","2011","March","823302","774847","48455","5.9","7.6"
"MIDDLESEX COUNTY","2011","April","823666","777210","46456","5.6","7.0"
"MIDDLESEX COUNTY","2011","May","821009","772932","48077","5.9","7.1"
"MIDDLESEX COUNTY","2011","June","832059","779153","52906","6.4","7.5"
"MIDDLESEX COUNTY","2011","July","834573","781947","52626","6.3","7.5"
"MIDDLESEX COUNTY","2011","August","837378","787971","49407","5.9","7.0"
"MIDDLESEX COUNTY","2011","September","825692","776244","49448","6.0","7.1"
"MIDDLESEX COUNTY","2011","October","830139","784460","45679","5.5","6.6"
"MIDDLESEX COUNTY","2011","November","831182","788332","42850","5.2","6.4"
"MIDDLESEX COUNTY","2011","December","830925","788050","42875","5.2","6.5"
"MIDDLESEX COUNTY","2011","Annual","827631","778977","48654","5.9","7.2"
"MIDDLESEX COUNTY","2010","January","820003","758152","61851","7.5","9.3"
"MIDDLESEX COUNTY","2010","February","820455","760488","59967","7.3","9.1"
"MIDDLESEX COUNTY","2010","March","823869","766225","57644","7.0","8.7"
"MIDDLESEX COUNTY","2010","April","825194","770296","54898","6.7","8.0"
"MIDDLESEX COUNTY","2010","May","821713","766896","54817","6.7","7.9"
"MIDDLESEX COUNTY","2010","June","832411","774985","57426","6.9","8.1"
"MIDDLESEX COUNTY","2010","July","835329","777197","58132","7.0","8.1"
"MIDDLESEX COUNTY","2010","August","834073","779402","54671","6.6","7.7"
"MIDDLESEX COUNTY","2010","September","820246","765647","54599","6.7","7.8"
"MIDDLESEX COUNTY","2010","October","824218","773096","51122","6.2","7.3"
"MIDDLESEX COUNTY","2010","November","826946","775512","51434","6.2","7.5"
"MIDDLESEX COUNTY","2010","December","825832","776361","49471","6.0","7.4"
"MIDDLESEX COUNTY","2010","Annual","825858","770355","55503","6.7","8.1"
"MIDDLESEX COUNTY","2009","January","823557","771829","51728","6.3","7.8"
"MIDDLESEX COUNTY","2009","February","821980","769709","52271","6.4","8.1"
"MIDDLESEX COUNTY","2009","March","821869","770536","51333","6.2","8.1"
"MIDDLESEX COUNTY","2009","April","822845","772262","50583","6.1","7.5"
"MIDDLESEX COUNTY","2009","May","821204","766607","54597","6.6","8.0"
"MIDDLESEX COUNTY","2009","June","837713","775876","61837","7.4","8.4"
"MIDDLESEX COUNTY","2009","July","838861","776920","61941","7.4","8.5"
"MIDDLESEX COUNTY","2009","August","835919","775731","60188","7.2","8.2"
"MIDDLESEX COUNTY","2009","September","821668","758758","62910","7.7","8.4"
"MIDDLESEX COUNTY","2009","October","823828","765273","58555","7.1","8.1"
"MIDDLESEX COUNTY","2009","November","828313","770076","58237","7.0","7.9"
"MIDDLESEX COUNTY","2009","December","822757","764520","58237","7.1","8.2"
"MIDDLESEX COUNTY","2009","Annual","826709","769841","56868","6.9","8.1"
"MIDDLESEX COUNTY","2008","January","817255","783262","33993","4.2","5.2"
"MIDDLESEX COUNTY","2008","February","814098","781616","32482","4.0","5.1"
"MIDDLESEX COUNTY","2008","March","816078","784483","31595","3.9","4.9"
"MIDDLESEX COUNTY","2008","April","815750","785898","29852","3.7","4.4"
"MIDDLESEX COUNTY","2008","May","817139","782291","34848","4.3","4.9"
"MIDDLESEX COUNTY","2008","June","833933","793336","40597","4.9","5.3"
"MIDDLESEX COUNTY","2008","July","835163","795327","39836","4.8","5.5"
"MIDDLESEX COUNTY","2008","August","833937","795114","38823","4.7","5.4"
"MIDDLESEX COUNTY","2008","September","822182","780773","41409","5.0","5.5"
"MIDDLESEX COUNTY","2008","October","828120","789037","39083","4.7","5.4"
"MIDDLESEX COUNTY","2008","November","831336","789587","41749","5.0","5.7"
"MIDDLESEX COUNTY","2008","December","829093","785209","43884","5.3","6.3"
"MIDDLESEX COUNTY","2008","Annual","824507","787161","37346","4.5","5.3"
"MIDDLESEX COUNTY","2007","January","812868","777613","35255","4.3","5.4"
"MIDDLESEX COUNTY","2007","February","810414","777447","32967","4.1","5.1"
"MIDDLESEX COUNTY","2007","March","812329","782430","29899","3.7","4.7"
"MIDDLESEX COUNTY","2007","April","809903","780976","28927","3.6","4.3"
"MIDDLESEX COUNTY","2007","May","809675","779383","30292","3.7","4.3"
"MIDDLESEX COUNTY","2007","June","824906","790650","34256","4.2","4.6"
"MIDDLESEX COUNTY","2007","July","826093","793465","32628","3.9","4.7"
"MIDDLESEX COUNTY","2007","August","822634","793591","29043","3.5","4.3"
"MIDDLESEX COUNTY","2007","September","813502","782448","31054","3.8","4.4"
"MIDDLESEX COUNTY","2007","October","817492","790114","27378","3.3","4.0"
"MIDDLESEX COUNTY","2007","November","823564","795398","28166","3.4","4.0"
"MIDDLESEX COUNTY","2007","December","820357","791733","28624","3.5","4.3"
"MIDDLESEX COUNTY","2007","Annual","816978","786271","30707","3.8","4.5"
"MIDDLESEX COUNTY","2006","January","801280","766864","34416","4.3","5.3"
"MIDDLESEX COUNTY","2006","February","802753","768163","34590","4.3","5.3"
"MIDDLESEX COUNTY","2006","March","804184","771405","32779","4.1","5.0"
"MIDDLESEX COUNTY","2006","April","801597","769345","32252","4.0","4.6"
"MIDDLESEX COUNTY","2006","May","802494","769988","32506","4.1","4.6"
"MIDDLESEX COUNTY","2006","June","819641","783301","36340","4.4","4.8"
"MIDDLESEX COUNTY","2006","July","820384","785391","34993","4.3","5.0"
"MIDDLESEX COUNTY","2006","August","820490","787695","32795","4.0","4.6"
"MIDDLESEX COUNTY","2006","September","807668","773719","33949","4.2","4.7"
"MIDDLESEX COUNTY","2006","October","814641","785038","29603","3.6","4.1"
"MIDDLESEX COUNTY","2006","November","819398","788222","31176","3.8","4.3"
"MIDDLESEX COUNTY","2006","December","818515","788565","29950","3.7","4.3"
"MIDDLESEX COUNTY","2006","Annual","811087","778141","32946","4.1","4.7"
"MIDDLESEX COUNTY","2005","January","804746","769122","35624","4.4","5.5"
"MIDDLESEX COUNTY","2005","February","805355","770084","35271","4.4","5.5"
"MIDDLESEX COUNTY","2005","March","805997","772694","33303","4.1","5.1"
"MIDDLESEX COUNTY","2005","April","804902","773330","31572","3.9","4.6"
"MIDDLESEX COUNTY","2005","May","804025","772292","31733","3.9","4.7"
"MIDDLESEX COUNTY","2005","June","817360","781787","35573","4.4","4.9"
"MIDDLESEX COUNTY","2005","July","818877","784711","34166","4.2","4.9"
"MIDDLESEX COUNTY","2005","August","818388","786894","31494","3.8","4.5"
"MIDDLESEX COUNTY","2005","September","804139","770005","34134","4.2","4.8"
"MIDDLESEX COUNTY","2005","October","811580","780882","30698","3.8","4.3"
"MIDDLESEX COUNTY","2005","November","814084","782024","32060","3.9","4.5"
"MIDDLESEX COUNTY","2005","December","811729","781527","30202","3.7","4.5"
"MIDDLESEX COUNTY","2005","Annual","810099","777113","32986","4.1","4.8"
"MIDDLESEX COUNTY","2004","January","815359","773169","42190","5.2","6.1"
"MIDDLESEX COUNTY","2004","February","813281","773846","39435","4.8","5.8"
"MIDDLESEX COUNTY","2004","March","812575","773738","38837","4.8","5.7"
"MIDDLESEX COUNTY","2004","April","808586","773349","35237","4.4","5.0"
"MIDDLESEX COUNTY","2004","May","805797","769896","35901","4.5","5.0"
"MIDDLESEX COUNTY","2004","June","819911","779706","40205","4.9","5.4"
"MIDDLESEX COUNTY","2004","July","820711","782836","37875","4.6","5.3"
"MIDDLESEX COUNTY","2004","August","817302","782430","34872","4.3","4.8"
"MIDDLESEX COUNTY","2004","September","801108","766806","34302","4.3","4.8"
"MIDDLESEX COUNTY","2004","October","807555","776542","31013","3.8","4.4"
"MIDDLESEX COUNTY","2004","November","811596","780522","31074","3.8","4.5"
"MIDDLESEX COUNTY","2004","December","809093","778722","30371","3.8","4.5"
"MIDDLESEX COUNTY","2004","Annual","811907","775964","35943","4.4","5.1"
"MIDDLESEX COUNTY","2003","January","824405","778346","46059","5.6","6.3"
"MIDDLESEX COUNTY","2003","February","822992","778808","44184","5.4","6.1"
"MIDDLESEX COUNTY","2003","March","823572","779860","43712","5.3","6.0"
"MIDDLESEX COUNTY","2003","April","821172","779514","41658","5.1","5.5"
"MIDDLESEX COUNTY","2003","May","816643","773540","43103","5.3","5.7"
"MIDDLESEX COUNTY","2003","June","830706","782359","48347","5.8","6.2"
"MIDDLESEX COUNTY","2003","July","825537","779992","45545","5.5","6.0"
"MIDDLESEX COUNTY","2003","August","823441","779978","43463","5.3","5.6"
"MIDDLESEX COUNTY","2003","September","811673","767520","44153","5.4","5.7"
"MIDDLESEX COUNTY","2003","October","816606","777016","39590","4.8","5.2"
"MIDDLESEX COUNTY","2003","November","820819","781734","39085","4.8","5.2"
"MIDDLESEX COUNTY","2003","December","817420","780357","37063","4.5","5.1"
"MIDDLESEX COUNTY","2003","Annual","821249","778252","42997","5.2","5.7"
"MIDDLESEX COUNTY","2002","January","823903","783122","40781","4.9","5.6"
"MIDDLESEX COUNTY","2002","February","827931","788313","39618","4.8","5.4"
"MIDDLESEX COUNTY","2002","March","828564","788681","39883","4.8","5.4"
"MIDDLESEX COUNTY","2002","April","825866","787071","38795","4.7","5.0"
"MIDDLESEX COUNTY","2002","May","824128","785243","38885","4.7","4.9"
"MIDDLESEX COUNTY","2002","June","837511","792740","44771","5.3","5.4"
"MIDDLESEX COUNTY","2002","July","837628","793326","44302","5.3","5.4"
"MIDDLESEX COUNTY","2002","August","837268","795029","42239","5.0","5.1"
"MIDDLESEX COUNTY","2002","September","826891","782473","44418","5.4","5.2"
"MIDDLESEX COUNTY","2002","October","830611","789750","40861","4.9","4.9"
"MIDDLESEX COUNTY","2002","November","829498","788844","40654","4.9","5.1"
"MIDDLESEX COUNTY","2002","December","827228","786638","40590","4.9","5.3"
"MIDDLESEX COUNTY","2002","Annual","829752","788436","41316","5.0","5.2"
"MIDDLESEX COUNTY","2001","January","819098","796646","22452","2.7","3.7"
"MIDDLESEX COUNTY","2001","February","820167","798421","21746","2.7","3.5"
"MIDDLESEX COUNTY","2001","March","824698","801685","23013","2.8","3.6"
"MIDDLESEX COUNTY","2001","April","819997","798583","21414","2.6","3.2"
"MIDDLESEX COUNTY","2001","May","818697","795570","23127","2.8","3.3"
"MIDDLESEX COUNTY","2001","June","831941","803411","28530","3.4","3.8"
"MIDDLESEX COUNTY","2001","July","835171","805863","29308","3.5","3.9"
"MIDDLESEX COUNTY","2001","August","831677","802006","29671","3.6","3.9"
"MIDDLESEX COUNTY","2001","September","820888","789228","31660","3.9","4.0"
"MIDDLESEX COUNTY","2001","October","826442","795812","30630","3.7","4.0"
"MIDDLESEX COUNTY","2001","November","829156","796877","32279","3.9","4.2"
"MIDDLESEX COUNTY","2001","December","829284","795867","33417","4.0","4.4"
"MIDDLESEX COUNTY","2001","Annual","825602","798331","27271","3.3","3.8"
"NANTUCKET COUNTY","2020","January","6211","5494","717","11.5","3.5"
"NANTUCKET COUNTY","2020","February","6267","5550","717","11.4","3.3"
"NANTUCKET COUNTY","2020","March","6341","5666","675","10.6","3.6"
"NANTUCKET COUNTY","2020","April","7024","4958","2066","29.4","16.7"
"NANTUCKET COUNTY","2020","May","7546","6265","1281","17.0","15.6"
"NANTUCKET COUNTY","2020","June","9034","7988","1046","11.6","14.5"
"NANTUCKET COUNTY","2020","July","9831","9087","744","7.6","13.0"
"NANTUCKET COUNTY","2020","August","9832","9271","561","5.7","10.3"
"NANTUCKET COUNTY","2020","September","8269","7742","527","6.4","9.8"
"NANTUCKET COUNTY","2020","October","7506","7019","487","6.5","8.1"
"NANTUCKET COUNTY","2020","November","6789","6232","557","8.2","7.6"
"NANTUCKET COUNTY","2020","December","6821","6031","790","11.6","7.4"
"NANTUCKET COUNTY","2020","Annual","7622","6775","847","11.1","9.4"
"NANTUCKET COUNTY","2019","January","6235","5510","725","11.6","4.0"
"NANTUCKET COUNTY","2019","February","6163","5436","727","11.8","3.6"
"NANTUCKET COUNTY","2019","March","6266","5673","593","9.5","3.4"
"NANTUCKET COUNTY","2019","April","6600","6295","305","4.6","2.8"
"NANTUCKET COUNTY","2019","May","7643","7428","215","2.8","2.9"
"NANTUCKET COUNTY","2019","June","9230","9029","201","2.2","3.2"
"NANTUCKET COUNTY","2019","July","10387","10212","175","1.7","3.3"
"NANTUCKET COUNTY","2019","August","10248","10097","151","1.5","3.0"
"NANTUCKET COUNTY","2019","September","8550","8395","155","1.8","2.8"
"NANTUCKET COUNTY","2019","October","7692","7536","156","2.0","2.6"
"NANTUCKET COUNTY","2019","November","6837","6566","271","4.0","2.5"
"NANTUCKET COUNTY","2019","December","6812","6416","396","5.8","2.6"
"NANTUCKET COUNTY","2019","Annual","7722","7383","339","4.4","3.1"
"NANTUCKET COUNTY","2018","January","5983","5290","693","11.6","4.3"
"NANTUCKET COUNTY","2018","February","5927","5242","685","11.6","4.2"
"NANTUCKET COUNTY","2018","March","6039","5470","569","9.4","3.8"
"NANTUCKET COUNTY","2018","April","6459","6122","337","5.2","3.3"
"NANTUCKET COUNTY","2018","May","7463","7219","244","3.3","3.3"
"NANTUCKET COUNTY","2018","June","9228","9012","216","2.3","3.7"
"NANTUCKET COUNTY","2018","July","10217","10027","190","1.9","3.7"
"NANTUCKET COUNTY","2018","August","10109","9948","161","1.6","3.3"
"NANTUCKET COUNTY","2018","September","8464","8303","161","1.9","3.2"
"NANTUCKET COUNTY","2018","October","7701","7526","175","2.3","2.9"
"NANTUCKET COUNTY","2018","November","6828","6565","263","3.9","2.8"
"NANTUCKET COUNTY","2018","December","6779","6332","447","6.6","3.0"
"NANTUCKET COUNTY","2018","Annual","7600","7255","345","4.5","3.4"
"NANTUCKET COUNTY","2017","January","5798","5163","635","11.0","4.5"
"NANTUCKET COUNTY","2017","February","5786","5128","658","11.4","4.4"
"NANTUCKET COUNTY","2017","March","5823","5310","513","8.8","4.0"
"NANTUCKET COUNTY","2017","April","6204","5900","304","4.9","3.6"
"NANTUCKET COUNTY","2017","May","7059","6819","240","3.4","3.7"
"NANTUCKET COUNTY","2017","June","8696","8490","206","2.4","4.0"
"NANTUCKET COUNTY","2017","July","9716","9527","189","1.9","4.1"
"NANTUCKET COUNTY","2017","August","9754","9578","176","1.8","3.8"
"NANTUCKET COUNTY","2017","September","8220","8047","173","2.1","3.7"
"NANTUCKET COUNTY","2017","October","7275","7094","181","2.5","3.3"
"NANTUCKET COUNTY","2017","November","6513","6246","267","4.1","3.3"
"NANTUCKET COUNTY","2017","December","6377","5970","407","6.4","3.4"
"NANTUCKET COUNTY","2017","Annual","7268","6939","329","4.5","3.8"
"NANTUCKET COUNTY","2016","January","5660","5032","628","11.1","4.9"
"NANTUCKET COUNTY","2016","February","5542","4921","621","11.2","4.7"
"NANTUCKET COUNTY","2016","March","5681","5149","532","9.4","4.5"
"NANTUCKET COUNTY","2016","April","6094","5794","300","4.9","3.9"
"NANTUCKET COUNTY","2016","May","6859","6633","226","3.3","3.9"
"NANTUCKET COUNTY","2016","June","8366","8158","208","2.5","4.2"
"NANTUCKET COUNTY","2016","July","9429","9244","185","2.0","4.2"
"NANTUCKET COUNTY","2016","August","9417","9252","165","1.8","3.8"
"NANTUCKET COUNTY","2016","September","7925","7747","178","2.2","3.8"
"NANTUCKET COUNTY","2016","October","7125","6941","184","2.6","3.5"
"NANTUCKET COUNTY","2016","November","6336","6078","258","4.1","3.3"
"NANTUCKET COUNTY","2016","December","6167","5779","388","6.3","3.5"
"NANTUCKET COUNTY","2016","Annual","7050","6727","323","4.6","4.0"
"NANTUCKET COUNTY","2015","January","5682","4967","715","12.6","5.8"
"NANTUCKET COUNTY","2015","February","5477","4785","692","12.6","5.5"
"NANTUCKET COUNTY","2015","March","5542","4926","616","11.1","5.2"
"NANTUCKET COUNTY","2015","April","6043","5698","345","5.7","4.6"
"NANTUCKET COUNTY","2015","May","7057","6773","284","4.0","4.9"
"NANTUCKET COUNTY","2015","June","8338","8079","259","3.1","5.0"
"NANTUCKET COUNTY","2015","July","9218","8980","238","2.6","5.0"
"NANTUCKET COUNTY","2015","August","9181","8971","210","2.3","4.5"
"NANTUCKET COUNTY","2015","September","7911","7696","215","2.7","4.5"
"NANTUCKET COUNTY","2015","October","6952","6722","230","3.3","4.2"
"NANTUCKET COUNTY","2015","November","6205","5913","292","4.7","4.1"
"NANTUCKET COUNTY","2015","December","6067","5659","408","6.7","4.1"
"NANTUCKET COUNTY","2015","Annual","6972","6597","375","5.4","4.8"
"NANTUCKET COUNTY","2014","January","5491","4762","729","13.3","6.7"
"NANTUCKET COUNTY","2014","February","5485","4715","770","14.0","6.7"
"NANTUCKET COUNTY","2014","March","5582","4908","674","12.1","6.4"
"NANTUCKET COUNTY","2014","April","5981","5570","411","6.9","5.5"
"NANTUCKET COUNTY","2014","May","7008","6679","329","4.7","5.7"
"NANTUCKET COUNTY","2014","June","8179","7879","300","3.7","5.9"
"NANTUCKET COUNTY","2014","July","9213","8914","299","3.2","6.1"
"NANTUCKET COUNTY","2014","August","9207","8928","279","3.0","5.7"
"NANTUCKET COUNTY","2014","September","7858","7587","271","3.4","5.5"
"NANTUCKET COUNTY","2014","October","7103","6824","279","3.9","5.0"
"NANTUCKET COUNTY","2014","November","6284","5913","371","5.9","4.9"
"NANTUCKET COUNTY","2014","December","6226","5761","465","7.5","4.8"
"NANTUCKET COUNTY","2014","Annual","6968","6537","431","6.2","5.7"
"NANTUCKET COUNTY","2013","January","5290","4458","832","15.7","7.6"
"NANTUCKET COUNTY","2013","February","5247","4416","831","15.8","7.2"
"NANTUCKET COUNTY","2013","March","5230","4543","687","13.1","6.9"
"NANTUCKET COUNTY","2013","April","5681","5211","470","8.3","6.3"
"NANTUCKET COUNTY","2013","May","6544","6161","383","5.9","6.6"
"NANTUCKET COUNTY","2013","June","7802","7433","369","4.7","7.1"
"NANTUCKET COUNTY","2013","July","8798","8459","339","3.9","7.0"
"NANTUCKET COUNTY","2013","August","8730","8417","313","3.6","6.5"
"NANTUCKET COUNTY","2013","September","7531","7218","313","4.2","6.5"
"NANTUCKET COUNTY","2013","October","6625","6313","312","4.7","6.2"
"NANTUCKET COUNTY","2013","November","5824","5420","404","6.9","5.9"
"NANTUCKET COUNTY","2013","December","5905","5437","468","7.9","5.9"
"NANTUCKET COUNTY","2013","Annual","6601","6124","477","7.2","6.6"
"NANTUCKET COUNTY","2012","January","5064","4271","793","15.7","7.4"
"NANTUCKET COUNTY","2012","February","5089","4285","804","15.8","7.3"
"NANTUCKET COUNTY","2012","March","5096","4400","696","13.7","6.9"
"NANTUCKET COUNTY","2012","April","5617","5128","489","8.7","6.3"
"NANTUCKET COUNTY","2012","May","6416","5984","432","6.7","6.5"
"NANTUCKET COUNTY","2012","June","7914","7526","388","4.9","6.9"
"NANTUCKET COUNTY","2012","July","8550","8182","368","4.3","7.1"
"NANTUCKET COUNTY","2012","August","8377","8029","348","4.2","6.7"
"NANTUCKET COUNTY","2012","September","7180","6838","342","4.8","6.5"
"NANTUCKET COUNTY","2012","October","6407","6056","351","5.5","6.3"
"NANTUCKET COUNTY","2012","November","5685","5222","463","8.1","6.1"
"NANTUCKET COUNTY","2012","December","5694","5123","571","10.0","6.4"
"NANTUCKET COUNTY","2012","Annual","6424","5920","504","7.8","6.7"
"NANTUCKET COUNTY","2011","January","4918","4078","840","17.1","8.3"
"NANTUCKET COUNTY","2011","February","4838","4005","833","17.2","8.0"
"NANTUCKET COUNTY","2011","March","4999","4234","765","15.3","7.6"
"NANTUCKET COUNTY","2011","April","5319","4809","510","9.6","7.0"
"NANTUCKET COUNTY","2011","May","6115","5671","444","7.3","7.1"
"NANTUCKET COUNTY","2011","June","7623","7216","407","5.3","7.5"
"NANTUCKET COUNTY","2011","July","8357","7969","388","4.6","7.5"
"NANTUCKET COUNTY","2011","August","8329","7952","377","4.5","7.0"
"NANTUCKET COUNTY","2011","September","7134","6737","397","5.6","7.1"
"NANTUCKET COUNTY","2011","October","6295","5908","387","6.1","6.6"
"NANTUCKET COUNTY","2011","November","5530","5039","491","8.9","6.4"
"NANTUCKET COUNTY","2011","December","5376","4792","584","10.9","6.5"
"NANTUCKET COUNTY","2011","Annual","6236","5701","535","8.6","7.2"
"NANTUCKET COUNTY","2010","January","5029","4145","884","17.6","9.3"
"NANTUCKET COUNTY","2010","February","4948","4045","903","18.2","9.1"
"NANTUCKET COUNTY","2010","March","5049","4223","826","16.4","8.7"
"NANTUCKET COUNTY","2010","April","5507","4922","585","10.6","8.0"
"NANTUCKET COUNTY","2010","May","6136","5648","488","8.0","7.9"
"NANTUCKET COUNTY","2010","June","7360","6925","435","5.9","8.1"
"NANTUCKET COUNTY","2010","July","8100","7685","415","5.1","8.1"
"NANTUCKET COUNTY","2010","August","8044","7648","396","4.9","7.7"
"NANTUCKET COUNTY","2010","September","6978","6564","414","5.9","7.8"
"NANTUCKET COUNTY","2010","October","6097","5686","411","6.7","7.3"
"NANTUCKET COUNTY","2010","November","5412","4854","558","10.3","7.5"
"NANTUCKET COUNTY","2010","December","5345","4738","607","11.4","7.4"
"NANTUCKET COUNTY","2010","Annual","6167","5590","577","9.4","8.1"
"NORFOLK COUNTY","2020","January","398406","386780","11626","2.9","3.5"
"NORFOLK COUNTY","2020","February","399212","388385","10827","2.7","3.3"
"NORFOLK COUNTY","2020","March","393652","381681","11971","3.0","3.6"
"NORFOLK COUNTY","2020","April","361641","304310","57331","15.9","16.7"
"NORFOLK COUNTY","2020","May","381721","323969","57752","15.1","15.6"
"NORFOLK COUNTY","2020","June","393701","339136","54565","13.9","14.5"
"NORFOLK COUNTY","2020","July","395197","346500","48697","12.3","13.0"
"NORFOLK COUNTY","2020","August","394626","355997","38629","9.8","10.3"
"NORFOLK COUNTY","2020","September","390652","353952","36700","9.4","9.8"
"NORFOLK COUNTY","2020","October","392323","361644","30679","7.8","8.1"
"NORFOLK COUNTY","2020","November","390916","362558","28358","7.3","7.6"
"NORFOLK COUNTY","2020","December","388225","362457","25768","6.6","7.4"
"NORFOLK COUNTY","2020","Annual","390023","355614","34409","8.8","9.4"
"NORFOLK COUNTY","2019","January","397338","384236","13102","3.3","4.0"
"NORFOLK COUNTY","2019","February","398170","386399","11771","3.0","3.6"
"NORFOLK COUNTY","2019","March","398433","387187","11246","2.8","3.4"
"NORFOLK COUNTY","2019","April","396672","387111","9561","2.4","2.8"
"NORFOLK COUNTY","2019","May","396010","385625","10385","2.6","2.9"
"NORFOLK COUNTY","2019","June","401690","390205","11485","2.9","3.2"
"NORFOLK COUNTY","2019","July","402535","390586","11949","3.0","3.3"
"NORFOLK COUNTY","2019","August","401770","391195","10575","2.6","3.0"
"NORFOLK COUNTY","2019","September","395710","385470","10240","2.6","2.8"
"NORFOLK COUNTY","2019","October","398526","389217","9309","2.3","2.6"
"NORFOLK COUNTY","2019","November","398892","390033","8859","2.2","2.5"
"NORFOLK COUNTY","2019","December","397781","389087","8694","2.2","2.6"
"NORFOLK COUNTY","2019","Annual","398627","388029","10598","2.7","3.1"
"NORFOLK COUNTY","2018","January","385596","372045","13551","3.5","4.3"
"NORFOLK COUNTY","2018","February","389921","376269","13652","3.5","4.2"
"NORFOLK COUNTY","2018","March","391151","378557","12594","3.2","3.8"
"NORFOLK COUNTY","2018","April","391219","379870","11349","2.9","3.3"
"NORFOLK COUNTY","2018","May","391762","380134","11628","3.0","3.3"
"NORFOLK COUNTY","2018","June","396861","383259","13602","3.4","3.7"
"NORFOLK COUNTY","2018","July","398344","384812","13532","3.4","3.7"
"NORFOLK COUNTY","2018","August","395056","382979","12077","3.1","3.3"
"NORFOLK COUNTY","2018","September","391236","379547","11689","3.0","3.2"
"NORFOLK COUNTY","2018","October","393957","383240","10717","2.7","2.9"
"NORFOLK COUNTY","2018","November","394627","384636","9991","2.5","2.8"
"NORFOLK COUNTY","2018","December","394505","384249","10256","2.6","3.0"
"NORFOLK COUNTY","2018","Annual","392853","380800","12053","3.1","3.4"
"NORFOLK COUNTY","2017","January","378074","363882","14192","3.8","4.5"
"NORFOLK COUNTY","2017","February","379799","365968","13831","3.6","4.4"
"NORFOLK COUNTY","2017","March","382196","369175","13021","3.4","4.0"
"NORFOLK COUNTY","2017","April","381563","369543","12020","3.2","3.6"
"NORFOLK COUNTY","2017","May","380596","367615","12981","3.4","3.7"
"NORFOLK COUNTY","2017","June","385863","371605","14258","3.7","4.0"
"NORFOLK COUNTY","2017","July","387383","372898","14485","3.7","4.1"
"NORFOLK COUNTY","2017","August","386133","372719","13414","3.5","3.8"
"NORFOLK COUNTY","2017","September","382470","369308","13162","3.4","3.7"
"NORFOLK COUNTY","2017","October","382812","370911","11901","3.1","3.3"
"NORFOLK COUNTY","2017","November","385060","373454","11606","3.0","3.3"
"NORFOLK COUNTY","2017","December","384907","373479","11428","3.0","3.4"
"NORFOLK COUNTY","2017","Annual","383071","370046","13025","3.4","3.8"
"NORFOLK COUNTY","2016","January","366861","352189","14672","4.0","4.9"
"NORFOLK COUNTY","2016","February","369293","354850","14443","3.9","4.7"
"NORFOLK COUNTY","2016","March","371254","357188","14066","3.8","4.5"
"NORFOLK COUNTY","2016","April","371038","358238","12800","3.4","3.9"
"NORFOLK COUNTY","2016","May","369154","356423","12731","3.4","3.9"
"NORFOLK COUNTY","2016","June","374478","360382","14096","3.8","4.2"
"NORFOLK COUNTY","2016","July","377751","363686","14065","3.7","4.2"
"NORFOLK COUNTY","2016","August","376818","364092","12726","3.4","3.8"
"NORFOLK COUNTY","2016","September","371614","358758","12856","3.5","3.8"
"NORFOLK COUNTY","2016","October","373333","361703","11630","3.1","3.5"
"NORFOLK COUNTY","2016","November","374536","363475","11061","3.0","3.3"
"NORFOLK COUNTY","2016","December","374726","363384","11342","3.0","3.5"
"NORFOLK COUNTY","2016","Annual","372572","359531","13041","3.5","4.0"
"NORFOLK COUNTY","2015","January","368112","350179","17933","4.9","5.8"
"NORFOLK COUNTY","2015","February","368243","351116","17127","4.7","5.5"
"NORFOLK COUNTY","2015","March","368705","352679","16026","4.3","5.2"
"NORFOLK COUNTY","2015","April","368893","354098","14795","4.0","4.6"
"NORFOLK COUNTY","2015","May","369249","353287","15962","4.3","4.9"
"NORFOLK COUNTY","2015","June","372999","356501","16498","4.4","5.0"
"NORFOLK COUNTY","2015","July","373297","356601","16696","4.5","5.0"
"NORFOLK COUNTY","2015","August","371482","356632","14850","4.0","4.5"
"NORFOLK COUNTY","2015","September","363860","349135","14725","4.0","4.5"
"NORFOLK COUNTY","2015","October","367909","354311","13598","3.7","4.2"
"NORFOLK COUNTY","2015","November","369066","355820","13246","3.6","4.1"
"NORFOLK COUNTY","2015","December","368426","355610","12816","3.5","4.1"
"NORFOLK COUNTY","2015","Annual","369187","353831","15356","4.2","4.8"
"NORFOLK COUNTY","2014","January","360687","340478","20209","5.6","6.7"
"NORFOLK COUNTY","2014","February","363008","342714","20294","5.6","6.7"
"NORFOLK COUNTY","2014","March","365359","345704","19655","5.4","6.4"
"NORFOLK COUNTY","2014","April","363205","345932","17273","4.8","5.5"
"NORFOLK COUNTY","2014","May","364761","346195","18566","5.1","5.7"
"NORFOLK COUNTY","2014","June","370314","350934","19380","5.2","5.9"
"NORFOLK COUNTY","2014","July","372452","352219","20233","5.4","6.1"
"NORFOLK COUNTY","2014","August","370773","352207","18566","5.0","5.7"
"NORFOLK COUNTY","2014","September","366246","347947","18299","5.0","5.5"
"NORFOLK COUNTY","2014","October","370816","354153","16663","4.5","5.0"
"NORFOLK COUNTY","2014","November","372036","356011","16025","4.3","4.9"
"NORFOLK COUNTY","2014","December","369939","354979","14960","4.0","4.8"
"NORFOLK COUNTY","2014","Annual","367467","349123","18344","5.0","5.7"
"NORFOLK COUNTY","2013","January","360482","337780","22702","6.3","7.6"
"NORFOLK COUNTY","2013","February","359936","338402","21534","6.0","7.2"
"NORFOLK COUNTY","2013","March","360280","339950","20330","5.6","6.9"
"NORFOLK COUNTY","2013","April","361312","341486","19826","5.5","6.3"
"NORFOLK COUNTY","2013","May","361805","340664","21141","5.8","6.6"
"NORFOLK COUNTY","2013","June","367139","344238","22901","6.2","7.1"
"NORFOLK COUNTY","2013","July","368060","345226","22834","6.2","7.0"
"NORFOLK COUNTY","2013","August","366402","345590","20812","5.7","6.5"
"NORFOLK COUNTY","2013","September","361615","340560","21055","5.8","6.5"
"NORFOLK COUNTY","2013","October","361836","341669","20167","5.6","6.2"
"NORFOLK COUNTY","2013","November","363579","344984","18595","5.1","5.9"
"NORFOLK COUNTY","2013","December","362472","344262","18210","5.0","5.9"
"NORFOLK COUNTY","2013","Annual","362910","342068","20842","5.7","6.6"
"NORFOLK COUNTY","2012","January","357338","335593","21745","6.1","7.4"
"NORFOLK COUNTY","2012","February","358681","337099","21582","6.0","7.3"
"NORFOLK COUNTY","2012","March","359618","339064","20554","5.7","6.9"
"NORFOLK COUNTY","2012","April","358335","339034","19301","5.4","6.3"
"NORFOLK COUNTY","2012","May","358780","338691","20089","5.6","6.5"
"NORFOLK COUNTY","2012","June","364484","342610","21874","6.0","6.9"
"NORFOLK COUNTY","2012","July","365130","342454","22676","6.2","7.1"
"NORFOLK COUNTY","2012","August","363894","343048","20846","5.7","6.7"
"NORFOLK COUNTY","2012","September","359668","339019","20649","5.7","6.5"
"NORFOLK COUNTY","2012","October","362771","342925","19846","5.5","6.3"
"NORFOLK COUNTY","2012","November","361958","343051","18907","5.2","6.1"
"NORFOLK COUNTY","2012","December","361611","341836","19775","5.5","6.4"
"NORFOLK COUNTY","2012","Annual","361023","340369","20654","5.7","6.7"
"NORFOLK COUNTY","2011","January","355899","331132","24767","7.0","8.3"
"NORFOLK COUNTY","2011","February","355699","331768","23931","6.7","8.0"
"NORFOLK COUNTY","2011","March","357214","334464","22750","6.4","7.6"
"NORFOLK COUNTY","2011","April","357490","335589","21901","6.1","7.0"
"NORFOLK COUNTY","2011","May","356078","333562","22516","6.3","7.1"
"NORFOLK COUNTY","2011","June","360208","336075","24133","6.7","7.5"
"NORFOLK COUNTY","2011","July","361558","337735","23823","6.6","7.5"
"NORFOLK COUNTY","2011","August","362942","340677","22265","6.1","7.0"
"NORFOLK COUNTY","2011","September","358078","335388","22690","6.3","7.1"
"NORFOLK COUNTY","2011","October","360230","338992","21238","5.9","6.6"
"NORFOLK COUNTY","2011","November","360593","340654","19939","5.5","6.4"
"NORFOLK COUNTY","2011","December","360144","340302","19842","5.5","6.5"
"NORFOLK COUNTY","2011","Annual","358845","336362","22483","6.3","7.2"
"NORFOLK COUNTY","2010","January","355710","327026","28684","8.1","9.3"
"NORFOLK COUNTY","2010","February","356396","328279","28117","7.9","9.1"
"NORFOLK COUNTY","2010","March","357920","330786","27134","7.6","8.7"
"NORFOLK COUNTY","2010","April","358394","332340","26054","7.3","8.0"
"NORFOLK COUNTY","2010","May","356793","330914","25879","7.3","7.9"
"NORFOLK COUNTY","2010","June","360920","334201","26719","7.4","8.1"
"NORFOLK COUNTY","2010","July","362233","335001","27232","7.5","8.1"
"NORFOLK COUNTY","2010","August","361749","336179","25570","7.1","7.7"
"NORFOLK COUNTY","2010","September","355889","330429","25460","7.2","7.8"
"NORFOLK COUNTY","2010","October","357293","333627","23666","6.6","7.3"
"NORFOLK COUNTY","2010","November","358329","334661","23668","6.6","7.5"
"NORFOLK COUNTY","2010","December","357262","334827","22435","6.3","7.4"
"NORFOLK COUNTY","2010","Annual","358241","332356","25885","7.2","8.1"
"NORFOLK COUNTY","2009","January","356200","332168","24032","6.7","7.8"
"NORFOLK COUNTY","2009","February","356019","331662","24357","6.8","8.1"
"NORFOLK COUNTY","2009","March","356328","332110","24218","6.8","8.1"
"NORFOLK COUNTY","2009","April","356643","332885","23758","6.7","7.5"
"NORFOLK COUNTY","2009","May","355618","330315","25303","7.1","8.0"
"NORFOLK COUNTY","2009","June","362530","334244","28286","7.8","8.4"
"NORFOLK COUNTY","2009","July","363091","335045","28046","7.7","8.5"
"NORFOLK COUNTY","2009","August","361855","334588","27267","7.5","8.2"
"NORFOLK COUNTY","2009","September","355784","327358","28426","8.0","8.4"
"NORFOLK COUNTY","2009","October","356979","330198","26781","7.5","8.1"
"NORFOLK COUNTY","2009","November","358774","332178","26596","7.4","7.9"
"NORFOLK COUNTY","2009","December","356431","329682","26749","7.5","8.2"
"NORFOLK COUNTY","2009","Annual","358021","331869","26152","7.3","8.1"
"NORFOLK COUNTY","2008","January","353868","338167","15701","4.4","5.2"
"NORFOLK COUNTY","2008","February","353085","337867","15218","4.3","5.1"
"NORFOLK COUNTY","2008","March","354129","339172","14957","4.2","4.9"
"NORFOLK COUNTY","2008","April","354344","339843","14501","4.1","4.4"
"NORFOLK COUNTY","2008","May","354217","337854","16363","4.6","4.9"
"NORFOLK COUNTY","2008","June","361484","342629","18855","5.2","5.3"
"NORFOLK COUNTY","2008","July","362341","343686","18655","5.1","5.5"
"NORFOLK COUNTY","2008","August","361803","343650","18153","5.0","5.4"
"NORFOLK COUNTY","2008","September","356633","337473","19160","5.4","5.5"
"NORFOLK COUNTY","2008","October","359407","341061","18346","5.1","5.4"
"NORFOLK COUNTY","2008","November","360742","341193","19549","5.4","5.7"
"NORFOLK COUNTY","2008","December","359574","339125","20449","5.7","6.3"
"NORFOLK COUNTY","2008","Annual","357635","340143","17492","4.9","5.3"
"NORFOLK COUNTY","2007","January","352853","336538","16315","4.6","5.4"
"NORFOLK COUNTY","2007","February","352216","336808","15408","4.4","5.1"
"NORFOLK COUNTY","2007","March","352868","338830","14038","4.0","4.7"
"NORFOLK COUNTY","2007","April","351656","338158","13498","3.8","4.3"
"NORFOLK COUNTY","2007","May","351140","337167","13973","4.0","4.3"
"NORFOLK COUNTY","2007","June","357516","341969","15547","4.3","4.6"
"NORFOLK COUNTY","2007","July","358532","343534","14998","4.2","4.7"
"NORFOLK COUNTY","2007","August","356985","343623","13362","3.7","4.3"
"NORFOLK COUNTY","2007","September","352715","338544","14171","4.0","4.4"
"NORFOLK COUNTY","2007","October","354722","342152","12570","3.5","4.0"
"NORFOLK COUNTY","2007","November","357399","344393","13006","3.6","4.0"
"NORFOLK COUNTY","2007","December","355785","342623","13162","3.7","4.3"
"NORFOLK COUNTY","2007","Annual","354533","340362","14171","4.0","4.5"
"NORFOLK COUNTY","2006","January","347231","331524","15707","4.5","5.3"
"NORFOLK COUNTY","2006","February","348227","332285","15942","4.6","5.3"
"NORFOLK COUNTY","2006","March","348951","333709","15242","4.4","5.0"
"NORFOLK COUNTY","2006","April","347971","332952","15019","4.3","4.6"
"NORFOLK COUNTY","2006","May","348252","333164","15088","4.3","4.6"
"NORFOLK COUNTY","2006","June","355594","338951","16643","4.7","4.8"
"NORFOLK COUNTY","2006","July","355888","340060","15828","4.4","5.0"
"NORFOLK COUNTY","2006","August","355994","341249","14745","4.1","4.6"
"NORFOLK COUNTY","2006","September","350489","335157","15332","4.4","4.7"
"NORFOLK COUNTY","2006","October","353887","340355","13532","3.8","4.1"
"NORFOLK COUNTY","2006","November","356011","341715","14296","4.0","4.3"
"NORFOLK COUNTY","2006","December","355425","341671","13754","3.9","4.3"
"NORFOLK COUNTY","2006","Annual","351993","336899","15094","4.3","4.7"
"NORFOLK COUNTY","2005","January","353799","337651","16148","4.6","5.5"
"NORFOLK COUNTY","2005","February","354076","338147","15929","4.5","5.5"
"NORFOLK COUNTY","2005","March","354489","339408","15081","4.3","5.1"
"NORFOLK COUNTY","2005","April","353528","339335","14193","4.0","4.6"
"NORFOLK COUNTY","2005","May","352743","338674","14069","4.0","4.7"
"NORFOLK COUNTY","2005","June","358442","342793","15649","4.4","4.9"
"NORFOLK COUNTY","2005","July","359476","344426","15050","4.2","4.9"
"NORFOLK COUNTY","2005","August","359451","345621","13830","3.8","4.5"
"NORFOLK COUNTY","2005","September","353322","338031","15291","4.3","4.8"
"NORFOLK COUNTY","2005","October","356645","342830","13815","3.9","4.3"
"NORFOLK COUNTY","2005","November","357792","343330","14462","4.0","4.5"
"NORFOLK COUNTY","2005","December","356876","343038","13838","3.9","4.5"
"NORFOLK COUNTY","2005","Annual","355887","341107","14780","4.2","4.8"
"NORFOLK COUNTY","2004","January","357325","338727","18598","5.2","6.1"
"NORFOLK COUNTY","2004","February","356655","339264","17391","4.9","5.8"
"NORFOLK COUNTY","2004","March","356278","339246","17032","4.8","5.7"
"NORFOLK COUNTY","2004","April","354252","338749","15503","4.4","5.0"
"NORFOLK COUNTY","2004","May","352978","337059","15919","4.5","5.0"
"NORFOLK COUNTY","2004","June","359076","341323","17753","4.9","5.4"
"NORFOLK COUNTY","2004","July","359578","342764","16814","4.7","5.3"
"NORFOLK COUNTY","2004","August","358350","342723","15627","4.4","4.8"
"NORFOLK COUNTY","2004","September","351248","335798","15450","4.4","4.8"
"NORFOLK COUNTY","2004","October","353979","340001","13978","3.9","4.4"
"NORFOLK COUNTY","2004","November","355757","341723","14034","3.9","4.5"
"NORFOLK COUNTY","2004","December","354699","340867","13832","3.9","4.5"
"NORFOLK COUNTY","2004","Annual","355848","339854","15994","4.5","5.1"
"NORFOLK COUNTY","2003","January","358525","340038","18487","5.2","6.3"
"NORFOLK COUNTY","2003","February","358237","340191","18046","5.0","6.1"
"NORFOLK COUNTY","2003","March","358571","340814","17757","5.0","6.0"
"NORFOLK COUNTY","2003","April","357667","340643","17024","4.8","5.5"
"NORFOLK COUNTY","2003","May","355982","338071","17911","5.0","5.7"
"NORFOLK COUNTY","2003","June","361823","341672","20151","5.6","6.2"
"NORFOLK COUNTY","2003","July","359966","340979","18987","5.3","6.0"
"NORFOLK COUNTY","2003","August","359398","340863","18535","5.2","5.6"
"NORFOLK COUNTY","2003","September","354271","335191","19080","5.4","5.7"
"NORFOLK COUNTY","2003","October","356733","339429","17304","4.9","5.2"
"NORFOLK COUNTY","2003","November","358380","341309","17071","4.8","5.2"
"NORFOLK COUNTY","2003","December","357011","340748","16263","4.6","5.1"
"NORFOLK COUNTY","2003","Annual","358047","339996","18051","5.0","5.7"
"NORFOLK COUNTY","2002","January","357029","340982","16047","4.5","5.6"
"NORFOLK COUNTY","2002","February","359239","343553","15686","4.4","5.4"
"NORFOLK COUNTY","2002","March","360197","343915","16282","4.5","5.4"
"NORFOLK COUNTY","2002","April","358872","343041","15831","4.4","5.0"
"NORFOLK COUNTY","2002","May","358234","342167","16067","4.5","4.9"
"NORFOLK COUNTY","2002","June","363908","345505","18403","5.1","5.4"
"NORFOLK COUNTY","2002","July","364275","346060","18215","5.0","5.4"
"NORFOLK COUNTY","2002","August","364290","347087","17203","4.7","5.1"
"NORFOLK COUNTY","2002","September","359570","341636","17934","5.0","5.2"
"NORFOLK COUNTY","2002","October","360991","344781","16210","4.5","4.9"
"NORFOLK COUNTY","2002","November","361074","344693","16381","4.5","5.1"
"NORFOLK COUNTY","2002","December","360124","343800","16324","4.5","5.3"
"NORFOLK COUNTY","2002","Annual","360650","343935","16715","4.6","5.2"
"NORFOLK COUNTY","2001","January","355767","345334","10433","2.9","3.7"
"NORFOLK COUNTY","2001","February","356660","346393","10267","2.9","3.5"
"NORFOLK COUNTY","2001","March","358477","347899","10578","3.0","3.6"
"NORFOLK COUNTY","2001","April","355691","346055","9636","2.7","3.2"
"NORFOLK COUNTY","2001","May","354408","344408","10000","2.8","3.3"
"NORFOLK COUNTY","2001","June","359874","347844","12030","3.3","3.8"
"NORFOLK COUNTY","2001","July","361519","349428","12091","3.3","3.9"
"NORFOLK COUNTY","2001","August","359619","347940","11679","3.2","3.9"
"NORFOLK COUNTY","2001","September","354588","342121","12467","3.5","4.0"
"NORFOLK COUNTY","2001","October","356884","345060","11824","3.3","4.0"
"NORFOLK COUNTY","2001","November","358052","345778","12274","3.4","4.2"
"NORFOLK COUNTY","2001","December","358450","345625","12825","3.6","4.4"
"NORFOLK COUNTY","2001","Annual","357499","346157","11342","3.2","3.8"
"PLYMOUTH COUNTY","2020","January","287747","276791","10956","3.8","3.5"
"PLYMOUTH COUNTY","2020","February","288063","277776","10287","3.6","3.3"
"PLYMOUTH COUNTY","2020","March","284412","273256","11156","3.9","3.6"
"PLYMOUTH COUNTY","2020","April","265876","215982","49894","18.8","16.7"
"PLYMOUTH COUNTY","2020","May","280141","231270","48871","17.4","15.6"
"PLYMOUTH COUNTY","2020","June","287900","243530","44370","15.4","14.5"
"PLYMOUTH COUNTY","2020","July","288356","249906","38450","13.3","13.0"
"PLYMOUTH COUNTY","2020","August","287577","257160","30417","10.6","10.3"
"PLYMOUTH COUNTY","2020","September","283764","255400","28364","10.0","9.8"
"PLYMOUTH COUNTY","2020","October","283956","260517","23439","8.3","8.1"
"PLYMOUTH COUNTY","2020","November","283427","261204","22223","7.8","7.6"
"PLYMOUTH COUNTY","2020","December","282387","260974","21413","7.6","7.4"
"PLYMOUTH COUNTY","2020","Annual","283634","255314","28320","10.0","9.4"
"PLYMOUTH COUNTY","2019","January","287800","275758","12042","4.2","4.0"
"PLYMOUTH COUNTY","2019","February","288778","277562","11216","3.9","3.6"
"PLYMOUTH COUNTY","2019","March","288435","278090","10345","3.6","3.4"
"PLYMOUTH COUNTY","2019","April","287024","278855","8169","2.8","2.8"
"PLYMOUTH COUNTY","2019","May","287006","278512","8494","3.0","2.9"
"PLYMOUTH COUNTY","2019","June","291431","282001","9430","3.2","3.2"
"PLYMOUTH COUNTY","2019","July","292872","282816","10056","3.4","3.3"
"PLYMOUTH COUNTY","2019","August","292279","283174","9105","3.1","3.0"
"PLYMOUTH COUNTY","2019","September","286852","278456","8396","2.9","2.8"
"PLYMOUTH COUNTY","2019","October","288185","280436","7749","2.7","2.6"
"PLYMOUTH COUNTY","2019","November","288177","280698","7479","2.6","2.5"
"PLYMOUTH COUNTY","2019","December","287597","279621","7976","2.8","2.6"
"PLYMOUTH COUNTY","2019","Annual","288870","279665","9205","3.2","3.1"
"PLYMOUTH COUNTY","2018","January","279938","267077","12861","4.6","4.3"
"PLYMOUTH COUNTY","2018","February","282654","269925","12729","4.5","4.2"
"PLYMOUTH COUNTY","2018","March","283395","271697","11698","4.1","3.8"
"PLYMOUTH COUNTY","2018","April","283150","273307","9843","3.5","3.3"
"PLYMOUTH COUNTY","2018","May","283574","273898","9676","3.4","3.3"
"PLYMOUTH COUNTY","2018","June","287714","276741","10973","3.8","3.7"
"PLYMOUTH COUNTY","2018","July","289642","278474","11168","3.9","3.7"
"PLYMOUTH COUNTY","2018","August","287290","277244","10046","3.5","3.3"
"PLYMOUTH COUNTY","2018","September","283519","274172","9347","3.3","3.2"
"PLYMOUTH COUNTY","2018","October","284753","276220","8533","3.0","2.9"
"PLYMOUTH COUNTY","2018","November","285231","277158","8073","2.8","2.8"
"PLYMOUTH COUNTY","2018","December","285464","276615","8849","3.1","3.0"
"PLYMOUTH COUNTY","2018","Annual","284693","274377","10316","3.6","3.4"
"PLYMOUTH COUNTY","2017","January","273992","260858","13134","4.8","4.5"
"PLYMOUTH COUNTY","2017","February","275447","262446","13001","4.7","4.4"
"PLYMOUTH COUNTY","2017","March","276722","264829","11893","4.3","4.0"
"PLYMOUTH COUNTY","2017","April","276176","265780","10396","3.8","3.6"
"PLYMOUTH COUNTY","2017","May","275929","265164","10765","3.9","3.7"
"PLYMOUTH COUNTY","2017","June","280023","268426","11597","4.1","4.0"
"PLYMOUTH COUNTY","2017","July","282515","270129","12386","4.4","4.1"
"PLYMOUTH COUNTY","2017","August","281536","270075","11461","4.1","3.8"
"PLYMOUTH COUNTY","2017","September","277580","266795","10785","3.9","3.7"
"PLYMOUTH COUNTY","2017","October","276988","267411","9577","3.5","3.3"
"PLYMOUTH COUNTY","2017","November","278378","268949","9429","3.4","3.3"
"PLYMOUTH COUNTY","2017","December","278592","268824","9768","3.5","3.4"
"PLYMOUTH COUNTY","2017","Annual","277824","266641","11183","4.0","3.8"
"PLYMOUTH COUNTY","2016","January","266614","252680","13934","5.2","4.9"
"PLYMOUTH COUNTY","2016","February","268554","254824","13730","5.1","4.7"
"PLYMOUTH COUNTY","2016","March","269953","256848","13105","4.9","4.5"
"PLYMOUTH COUNTY","2016","April","269153","257809","11344","4.2","3.9"
"PLYMOUTH COUNTY","2016","May","267884","257077","10807","4.0","3.9"
"PLYMOUTH COUNTY","2016","June","272317","260460","11857","4.4","4.2"
"PLYMOUTH COUNTY","2016","July","275478","263342","12136","4.4","4.2"
"PLYMOUTH COUNTY","2016","August","274769","263739","11030","4.0","3.8"
"PLYMOUTH COUNTY","2016","September","270076","259308","10768","4.0","3.8"
"PLYMOUTH COUNTY","2016","October","270128","260619","9509","3.5","3.5"
"PLYMOUTH COUNTY","2016","November","270561","261493","9068","3.4","3.3"
"PLYMOUTH COUNTY","2016","December","271029","261238","9791","3.6","3.5"
"PLYMOUTH COUNTY","2016","Annual","270543","259120","11423","4.2","4.0"
"PLYMOUTH COUNTY","2015","January","267073","250412","16661","6.2","5.8"
"PLYMOUTH COUNTY","2015","February","268001","251714","16287","6.1","5.5"
"PLYMOUTH COUNTY","2015","March","267928","252852","15076","5.6","5.2"
"PLYMOUTH COUNTY","2015","April","267513","254463","13050","4.9","4.6"
"PLYMOUTH COUNTY","2015","May","268086","254505","13581","5.1","4.9"
"PLYMOUTH COUNTY","2015","June","271633","257576","14057","5.2","5.0"
"PLYMOUTH COUNTY","2015","July","272106","257724","14382","5.3","5.0"
"PLYMOUTH COUNTY","2015","August","270648","257751","12897","4.8","4.5"
"PLYMOUTH COUNTY","2015","September","264098","251749","12349","4.7","4.5"
"PLYMOUTH COUNTY","2015","October","265943","254676","11267","4.2","4.2"
"PLYMOUTH COUNTY","2015","November","266337","255176","11161","4.2","4.1"
"PLYMOUTH COUNTY","2015","December","266517","254958","11559","4.3","4.1"
"PLYMOUTH COUNTY","2015","Annual","267990","254463","13527","5.0","4.8"
"PLYMOUTH COUNTY","2014","January","262369","243431","18938","7.2","6.7"
"PLYMOUTH COUNTY","2014","February","264728","245551","19177","7.2","6.7"
"PLYMOUTH COUNTY","2014","March","266270","247834","18436","6.9","6.4"
"PLYMOUTH COUNTY","2014","April","263717","248592","15125","5.7","5.5"
"PLYMOUTH COUNTY","2014","May","264717","249078","15639","5.9","5.7"
"PLYMOUTH COUNTY","2014","June","268975","252636","16339","6.1","5.9"
"PLYMOUTH COUNTY","2014","July","271050","253832","17218","6.4","6.1"
"PLYMOUTH COUNTY","2014","August","269395","253567","15828","5.9","5.7"
"PLYMOUTH COUNTY","2014","September","265680","250721","14959","5.6","5.5"
"PLYMOUTH COUNTY","2014","October","268262","254663","13599","5.1","5.0"
"PLYMOUTH COUNTY","2014","November","268789","255266","13523","5.0","4.9"
"PLYMOUTH COUNTY","2014","December","268063","254611","13452","5.0","4.8"
"PLYMOUTH COUNTY","2014","Annual","266834","250815","16019","6.0","5.7"
"PLYMOUTH COUNTY","2013","January","261752","240558","21194","8.1","7.6"
"PLYMOUTH COUNTY","2013","February","261874","241330","20544","7.8","7.2"
"PLYMOUTH COUNTY","2013","March","262122","242783","19339","7.4","6.9"
"PLYMOUTH COUNTY","2013","April","261549","244253","17296","6.6","6.3"
"PLYMOUTH COUNTY","2013","May","261886","244136","17750","6.8","6.6"
"PLYMOUTH COUNTY","2013","June","265986","246749","19237","7.2","7.1"
"PLYMOUTH COUNTY","2013","July","267147","247937","19210","7.2","7.0"
"PLYMOUTH COUNTY","2013","August","266402","248397","18005","6.8","6.5"
"PLYMOUTH COUNTY","2013","September","261399","243999","17400","6.7","6.5"
"PLYMOUTH COUNTY","2013","October","260653","244256","16397","6.3","6.2"
"PLYMOUTH COUNTY","2013","November","261775","246101","15674","6.0","5.9"
"PLYMOUTH COUNTY","2013","December","261530","245670","15860","6.1","5.9"
"PLYMOUTH COUNTY","2013","Annual","262840","244681","18159","6.9","6.6"
"PLYMOUTH COUNTY","2012","January","259566","238820","20746","8.0","7.4"
"PLYMOUTH COUNTY","2012","February","260429","239888","20541","7.9","7.3"
"PLYMOUTH COUNTY","2012","March","261425","241712","19713","7.5","6.9"
"PLYMOUTH COUNTY","2012","April","259360","242037","17323","6.7","6.3"
"PLYMOUTH COUNTY","2012","May","260285","242393","17892","6.9","6.5"
"PLYMOUTH COUNTY","2012","June","265439","246401","19038","7.2","6.9"
"PLYMOUTH COUNTY","2012","July","265406","245813","19593","7.4","7.1"
"PLYMOUTH COUNTY","2012","August","264646","246301","18345","6.9","6.7"
"PLYMOUTH COUNTY","2012","September","260514","242909","17605","6.8","6.5"
"PLYMOUTH COUNTY","2012","October","262308","245669","16639","6.3","6.3"
"PLYMOUTH COUNTY","2012","November","261069","244897","16172","6.2","6.1"
"PLYMOUTH COUNTY","2012","December","261587","243958","17629","6.7","6.4"
"PLYMOUTH COUNTY","2012","Annual","261836","243400","18436","7.0","6.7"
"PLYMOUTH COUNTY","2011","January","260945","237055","23890","9.2","8.3"
"PLYMOUTH COUNTY","2011","February","260952","237638","23314","8.9","8.0"
"PLYMOUTH COUNTY","2011","March","261702","239552","22150","8.5","7.6"
"PLYMOUTH COUNTY","2011","April","260500","240787","19713","7.6","7.0"
"PLYMOUTH COUNTY","2011","May","259833","240110","19723","7.6","7.1"
"PLYMOUTH COUNTY","2011","June","263048","242292","20756","7.9","7.5"
"PLYMOUTH COUNTY","2011","July","264482","243752","20730","7.8","7.5"
"PLYMOUTH COUNTY","2011","August","265110","245546","19564","7.4","7.0"
"PLYMOUTH COUNTY","2011","September","261112","241552","19560","7.5","7.1"
"PLYMOUTH COUNTY","2011","October","261449","243309","18140","6.9","6.6"
"PLYMOUTH COUNTY","2011","November","261395","244043","17352","6.6","6.4"
"PLYMOUTH COUNTY","2011","December","261913","243552","18361","7.0","6.5"
"PLYMOUTH COUNTY","2011","Annual","261870","241599","20271","7.7","7.2"
"PLYMOUTH COUNTY","2010","January","261012","234524","26488","10.1","9.3"
"PLYMOUTH COUNTY","2010","February","261216","235126","26090","10.0","9.1"
"PLYMOUTH COUNTY","2010","March","262158","236801","25357","9.7","8.7"
"PLYMOUTH COUNTY","2010","April","261082","238412","22670","8.7","8.0"
"PLYMOUTH COUNTY","2010","May","260496","238218","22278","8.6","7.9"
"PLYMOUTH COUNTY","2010","June","263495","240749","22746","8.6","8.1"
"PLYMOUTH COUNTY","2010","July","265486","242496","22990","8.7","8.1"
"PLYMOUTH COUNTY","2010","August","265081","243133","21948","8.3","7.7"
"PLYMOUTH COUNTY","2010","September","259957","238705","21252","8.2","7.8"
"PLYMOUTH COUNTY","2010","October","260656","240520","20136","7.7","7.3"
"PLYMOUTH COUNTY","2010","November","261192","240705","20487","7.8","7.5"
"PLYMOUTH COUNTY","2010","December","261295","240608","20687","7.9","7.4"
"PLYMOUTH COUNTY","2010","Annual","261927","239166","22761","8.7","8.1"
"PLYMOUTH COUNTY","2009","January","261767","239715","22052","8.4","7.8"
"PLYMOUTH COUNTY","2009","February","261668","239798","21870","8.4","8.1"
"PLYMOUTH COUNTY","2009","March","261718","240179","21539","8.2","8.1"
"PLYMOUTH COUNTY","2009","April","261801","241852","19949","7.6","7.5"
"PLYMOUTH COUNTY","2009","May","261484","240588","20896","8.0","8.0"
"PLYMOUTH COUNTY","2009","June","267556","244455","23101","8.6","8.4"
"PLYMOUTH COUNTY","2009","July","268897","245378","23519","8.7","8.5"
"PLYMOUTH COUNTY","2009","August","267960","245007","22953","8.6","8.2"
"PLYMOUTH COUNTY","2009","September","262755","239263","23492","8.9","8.4"
"PLYMOUTH COUNTY","2009","October","263041","240487","22554","8.6","8.1"
"PLYMOUTH COUNTY","2009","November","264178","241364","22814","8.6","7.9"
"PLYMOUTH COUNTY","2009","December","262853","239272","23581","9.0","8.2"
"PLYMOUTH COUNTY","2009","Annual","263807","241447","22360","8.5","8.1"
"PLYMOUTH COUNTY","2008","January","259022","243874","15148","5.8","5.2"
"PLYMOUTH COUNTY","2008","February","257826","243310","14516","5.6","5.1"
"PLYMOUTH COUNTY","2008","March","258741","244651","14090","5.4","4.9"
"PLYMOUTH COUNTY","2008","April","258199","245395","12804","5.0","4.4"
"PLYMOUTH COUNTY","2008","May","258836","245126","13710","5.3","4.9"
"PLYMOUTH COUNTY","2008","June","264608","248944","15664","5.9","5.3"
"PLYMOUTH COUNTY","2008","July","265783","249897","15886","6.0","5.5"
"PLYMOUTH COUNTY","2008","August","265244","249863","15381","5.8","5.4"
"PLYMOUTH COUNTY","2008","September","260896","244804","16092","6.2","5.5"
"PLYMOUTH COUNTY","2008","October","262386","246972","15414","5.9","5.4"
"PLYMOUTH COUNTY","2008","November","262992","246362","16630","6.3","5.7"
"PLYMOUTH COUNTY","2008","December","262840","244584","18256","6.9","6.3"
"PLYMOUTH COUNTY","2008","Annual","261448","246149","15299","5.9","5.3"
"PLYMOUTH COUNTY","2007","January","258922","243432","15490","6.0","5.4"
"PLYMOUTH COUNTY","2007","February","257839","243170","14669","5.7","5.1"
"PLYMOUTH COUNTY","2007","March","258465","245096","13369","5.2","4.7"
"PLYMOUTH COUNTY","2007","April","257401","245206","12195","4.7","4.3"
"PLYMOUTH COUNTY","2007","May","257438","245374","12064","4.7","4.3"
"PLYMOUTH COUNTY","2007","June","263306","249810","13496","5.1","4.6"
"PLYMOUTH COUNTY","2007","July","264440","251090","13350","5.0","4.7"
"PLYMOUTH COUNTY","2007","August","262896","251107","11789","4.5","4.3"
"PLYMOUTH COUNTY","2007","September","258860","246746","12114","4.7","4.4"
"PLYMOUTH COUNTY","2007","October","259257","248415","10842","4.2","4.0"
"PLYMOUTH COUNTY","2007","November","260624","249310","11314","4.3","4.0"
"PLYMOUTH COUNTY","2007","December","259790","247484","12306","4.7","4.3"
"PLYMOUTH COUNTY","2007","Annual","259937","247187","12750","4.9","4.5"
"PLYMOUTH COUNTY","2006","January","254925","240568","14357","5.6","5.3"
"PLYMOUTH COUNTY","2006","February","255103","240783","14320","5.6","5.3"
"PLYMOUTH COUNTY","2006","March","255597","242077","13520","5.3","5.0"
"PLYMOUTH COUNTY","2006","April","255043","242510","12533","4.9","4.6"
"PLYMOUTH COUNTY","2006","May","255675","243456","12219","4.8","4.6"
"PLYMOUTH COUNTY","2006","June","261910","248330","13580","5.2","4.8"
"PLYMOUTH COUNTY","2006","July","262458","248986","13472","5.1","5.0"
"PLYMOUTH COUNTY","2006","August","262164","249557","12607","4.8","4.6"
"PLYMOUTH COUNTY","2006","September","257667","244702","12965","5.0","4.7"
"PLYMOUTH COUNTY","2006","October","259522","248061","11461","4.4","4.1"
"PLYMOUTH COUNTY","2006","November","260440","248183","12257","4.7","4.3"
"PLYMOUTH COUNTY","2006","December","260561","248066","12495","4.8","4.3"
"PLYMOUTH COUNTY","2006","Annual","258422","245440","12982","5.0","4.7"
"PLYMOUTH COUNTY","2005","January","256508","242167","14341","5.6","5.5"
"PLYMOUTH COUNTY","2005","February","256310","242111","14199","5.5","5.5"
"PLYMOUTH COUNTY","2005","March","256675","243138","13537","5.3","5.1"
"PLYMOUTH COUNTY","2005","April","256263","244204","12059","4.7","4.6"
"PLYMOUTH COUNTY","2005","May","256416","244626","11790","4.6","4.7"
"PLYMOUTH COUNTY","2005","June","261686","248646","13040","5.0","4.9"
"PLYMOUTH COUNTY","2005","July","262050","249262","12788","4.9","4.9"
"PLYMOUTH COUNTY","2005","August","261759","250199","11560","4.4","4.5"
"PLYMOUTH COUNTY","2005","September","256972","244444","12528","4.9","4.8"
"PLYMOUTH COUNTY","2005","October","258720","247407","11313","4.4","4.3"
"PLYMOUTH COUNTY","2005","November","259140","247210","11930","4.6","4.5"
"PLYMOUTH COUNTY","2005","December","258497","246535","11962","4.6","4.5"
"PLYMOUTH COUNTY","2005","Annual","258416","245829","12587","4.9","4.8"
"PLYMOUTH COUNTY","2004","January","258108","242001","16107","6.2","6.1"
"PLYMOUTH COUNTY","2004","February","257005","241801","15204","5.9","5.8"
"PLYMOUTH COUNTY","2004","March","256979","242218","14761","5.7","5.7"
"PLYMOUTH COUNTY","2004","April","255987","243024","12963","5.1","5.0"
"PLYMOUTH COUNTY","2004","May","255709","242688","13021","5.1","5.0"
"PLYMOUTH COUNTY","2004","June","261126","246721","14405","5.5","5.4"
"PLYMOUTH COUNTY","2004","July","262002","248019","13983","5.3","5.3"
"PLYMOUTH COUNTY","2004","August","260817","248077","12740","4.9","4.8"
"PLYMOUTH COUNTY","2004","September","255072","242671","12401","4.9","4.8"
"PLYMOUTH COUNTY","2004","October","256193","245082","11111","4.3","4.4"
"PLYMOUTH COUNTY","2004","November","256879","245523","11356","4.4","4.5"
"PLYMOUTH COUNTY","2004","December","256242","244547","11695","4.6","4.5"
"PLYMOUTH COUNTY","2004","Annual","257676","244364","13312","5.2","5.1"
"PLYMOUTH COUNTY","2003","January","255943","241032","14911","5.8","6.3"
"PLYMOUTH COUNTY","2003","February","255953","241193","14760","5.8","6.1"
"PLYMOUTH COUNTY","2003","March","256519","242006","14513","5.7","6.0"
"PLYMOUTH COUNTY","2003","April","255952","242607","13345","5.2","5.5"
"PLYMOUTH COUNTY","2003","May","255517","242000","13517","5.3","5.7"
"PLYMOUTH COUNTY","2003","June","261018","245633","15385","5.9","6.2"
"PLYMOUTH COUNTY","2003","July","260865","245941","14924","5.7","6.0"
"PLYMOUTH COUNTY","2003","August","260657","246118","14539","5.6","5.6"
"PLYMOUTH COUNTY","2003","September","255918","241397","14521","5.7","5.7"
"PLYMOUTH COUNTY","2003","October","256826","243667","13159","5.1","5.2"
"PLYMOUTH COUNTY","2003","November","257701","244515","13186","5.1","5.2"
"PLYMOUTH COUNTY","2003","December","256760","243438","13322","5.2","5.1"
"PLYMOUTH COUNTY","2003","Annual","257470","243296","14174","5.5","5.7"
"PLYMOUTH COUNTY","2002","January","253704","241095","12609","5.0","5.6"
"PLYMOUTH COUNTY","2002","February","255195","242777","12418","4.9","5.4"
"PLYMOUTH COUNTY","2002","March","256153","243453","12700","5.0","5.4"
"PLYMOUTH COUNTY","2002","April","255522","243638","11884","4.7","5.0"
"PLYMOUTH COUNTY","2002","May","255758","244036","11722","4.6","4.9"
"PLYMOUTH COUNTY","2002","June","261109","247390","13719","5.3","5.4"
"PLYMOUTH COUNTY","2002","July","261911","248240","13671","5.2","5.4"
"PLYMOUTH COUNTY","2002","August","261710","248835","12875","4.9","5.1"
"PLYMOUTH COUNTY","2002","September","257706","244674","13032","5.1","5.2"
"PLYMOUTH COUNTY","2002","October","257553","245819","11734","4.6","4.9"
"PLYMOUTH COUNTY","2002","November","257336","245489","11847","4.6","5.1"
"PLYMOUTH COUNTY","2002","December","256501","244351","12150","4.7","5.3"
"PLYMOUTH COUNTY","2002","Annual","257513","244983","12530","4.9","5.2"
"PLYMOUTH COUNTY","2001","January","250747","241515","9232","3.7","3.7"
"PLYMOUTH COUNTY","2001","February","251124","242090","9034","3.6","3.5"
"PLYMOUTH COUNTY","2001","March","252898","243608","9290","3.7","3.6"
"PLYMOUTH COUNTY","2001","April","251184","243301","7883","3.1","3.2"
"PLYMOUTH COUNTY","2001","May","250891","242958","7933","3.2","3.3"
"PLYMOUTH COUNTY","2001","June","255499","246173","9326","3.7","3.8"
"PLYMOUTH COUNTY","2001","July","257236","247826","9410","3.7","3.9"
"PLYMOUTH COUNTY","2001","August","255169","246254","8915","3.5","3.9"
"PLYMOUTH COUNTY","2001","September","251133","242207","8926","3.6","4.0"
"PLYMOUTH COUNTY","2001","October","252424","244053","8371","3.3","4.0"
"PLYMOUTH COUNTY","2001","November","253136","244326","8810","3.5","4.2"
"PLYMOUTH COUNTY","2001","December","253190","243805","9385","3.7","4.4"
"PLYMOUTH COUNTY","2001","Annual","252886","244010","8876","3.5","3.8"
"SUFFOLK COUNTY","2020","January","458809","445196","13613","3.0","3.5"
"SUFFOLK COUNTY","2020","February","459449","447076","12373","2.7","3.3"
"SUFFOLK COUNTY","2020","March","453505","439327","14178","3.1","3.6"
"SUFFOLK COUNTY","2020","April","420251","350867","69384","16.5","16.7"
"SUFFOLK COUNTY","2020","May","448057","373094","74963","16.7","15.6"
"SUFFOLK COUNTY","2020","June","467952","390229","77723","16.6","14.5"
"SUFFOLK COUNTY","2020","July","470919","398711","72208","15.3","13.0"
"SUFFOLK COUNTY","2020","August","468063","409511","58552","12.5","10.3"
"SUFFOLK COUNTY","2020","September","461748","406982","54766","11.9","9.8"
"SUFFOLK COUNTY","2020","October","458335","415826","42509","9.3","8.1"
"SUFFOLK COUNTY","2020","November","454675","416881","37794","8.3","7.6"
"SUFFOLK COUNTY","2020","December","452614","416927","35687","7.9","7.4"
"SUFFOLK COUNTY","2020","Annual","456198","409219","46979","10.3","9.4"
"SUFFOLK COUNTY","2019","January","460299","444984","15315","3.3","4.0"
"SUFFOLK COUNTY","2019","February","460899","447503","13396","2.9","3.6"
"SUFFOLK COUNTY","2019","March","461404","448461","12943","2.8","3.4"
"SUFFOLK COUNTY","2019","April","459337","448317","11020","2.4","2.8"
"SUFFOLK COUNTY","2019","May","459178","446500","12678","2.8","2.9"
"SUFFOLK COUNTY","2019","June","466525","452002","14523","3.1","3.2"
"SUFFOLK COUNTY","2019","July","467485","452526","14959","3.2","3.3"
"SUFFOLK COUNTY","2019","August","466332","453155","13177","2.8","3.0"
"SUFFOLK COUNTY","2019","September","458705","446326","12379","2.7","2.8"
"SUFFOLK COUNTY","2019","October","462056","450776","11280","2.4","2.6"
"SUFFOLK COUNTY","2019","November","462413","451705","10708","2.3","2.5"
"SUFFOLK COUNTY","2019","December","460901","450654","10247","2.2","2.6"
"SUFFOLK COUNTY","2019","Annual","462128","449409","12719","2.8","3.1"
"SUFFOLK COUNTY","2018","January","449368","433351","16017","3.6","4.3"
"SUFFOLK COUNTY","2018","February","453715","438268","15447","3.4","4.2"
"SUFFOLK COUNTY","2018","March","455378","440919","14459","3.2","3.8"
"SUFFOLK COUNTY","2018","April","455208","442391","12817","2.8","3.3"
"SUFFOLK COUNTY","2018","May","456425","442588","13837","3.0","3.3"
"SUFFOLK COUNTY","2018","June","463481","446378","17103","3.7","3.7"
"SUFFOLK COUNTY","2018","July","464828","448284","16544","3.6","3.7"
"SUFFOLK COUNTY","2018","August","460650","446079","14571","3.2","3.3"
"SUFFOLK COUNTY","2018","September","455520","441899","13621","3.0","3.2"
"SUFFOLK COUNTY","2018","October","458839","446303","12536","2.7","2.9"
"SUFFOLK COUNTY","2018","November","459599","447914","11685","2.5","2.8"
"SUFFOLK COUNTY","2018","December","459342","447507","11835","2.6","3.0"
"SUFFOLK COUNTY","2018","Annual","457696","443490","14206","3.1","3.4"
"SUFFOLK COUNTY","2017","January","438553","421993","16560","3.8","4.5"
"SUFFOLK COUNTY","2017","February","440155","424405","15750","3.6","4.4"
"SUFFOLK COUNTY","2017","March","442784","428130","14654","3.3","4.0"
"SUFFOLK COUNTY","2017","April","442327","428493","13834","3.1","3.6"
"SUFFOLK COUNTY","2017","May","441615","426136","15479","3.5","3.7"
"SUFFOLK COUNTY","2017","June","448572","430908","17664","3.9","4.0"
"SUFFOLK COUNTY","2017","July","450529","432512","18017","4.0","4.1"
"SUFFOLK COUNTY","2017","August","448879","432230","16649","3.7","3.8"
"SUFFOLK COUNTY","2017","September","443843","428119","15724","3.5","3.7"
"SUFFOLK COUNTY","2017","October","443967","430024","13943","3.1","3.3"
"SUFFOLK COUNTY","2017","November","446632","433003","13629","3.1","3.3"
"SUFFOLK COUNTY","2017","December","446455","433050","13405","3.0","3.4"
"SUFFOLK COUNTY","2017","Annual","444526","429084","15442","3.5","3.8"
"SUFFOLK COUNTY","2016","January","420477","403091","17386","4.1","4.9"
"SUFFOLK COUNTY","2016","February","422517","406141","16376","3.9","4.7"
"SUFFOLK COUNTY","2016","March","424928","408771","16157","3.8","4.5"
"SUFFOLK COUNTY","2016","April","424849","410007","14842","3.5","3.9"
"SUFFOLK COUNTY","2016","May","423404","407841","15563","3.7","3.9"
"SUFFOLK COUNTY","2016","June","430300","412439","17861","4.2","4.2"
"SUFFOLK COUNTY","2016","July","434138","416466","17672","4.1","4.2"
"SUFFOLK COUNTY","2016","August","433071","416904","16167","3.7","3.8"
"SUFFOLK COUNTY","2016","September","426163","410594","15569","3.7","3.8"
"SUFFOLK COUNTY","2016","October","428102","414003","14099","3.3","3.5"
"SUFFOLK COUNTY","2016","November","429216","416058","13158","3.1","3.3"
"SUFFOLK COUNTY","2016","December","429328","415996","13332","3.1","3.5"
"SUFFOLK COUNTY","2016","Annual","427208","411526","15682","3.7","4.0"
"SUFFOLK COUNTY","2015","January","419400","398314","21086","5.0","5.8"
"SUFFOLK COUNTY","2015","February","418785","399408","19377","4.6","5.5"
"SUFFOLK COUNTY","2015","March","419289","401191","18098","4.3","5.2"
"SUFFOLK COUNTY","2015","April","420127","402740","17387","4.1","4.6"
"SUFFOLK COUNTY","2015","May","421393","401714","19679","4.7","4.9"
"SUFFOLK COUNTY","2015","June","426328","405444","20884","4.9","5.0"
"SUFFOLK COUNTY","2015","July","426640","405718","20922","4.9","5.0"
"SUFFOLK COUNTY","2015","August","424315","405722","18593","4.4","4.5"
"SUFFOLK COUNTY","2015","September","414982","396930","18052","4.4","4.5"
"SUFFOLK COUNTY","2015","October","419642","402937","16705","4.0","4.2"
"SUFFOLK COUNTY","2015","November","420640","404678","15962","3.8","4.1"
"SUFFOLK COUNTY","2015","December","419732","404428","15304","3.6","4.1"
"SUFFOLK COUNTY","2015","Annual","420939","402435","18504","4.4","4.8"
"SUFFOLK COUNTY","2014","January","407406","384051","23355","5.7","6.7"
"SUFFOLK COUNTY","2014","February","409274","386563","22711","5.5","6.7"
"SUFFOLK COUNTY","2014","March","411616","389930","21686","5.3","6.4"
"SUFFOLK COUNTY","2014","April","409820","390114","19706","4.8","5.5"
"SUFFOLK COUNTY","2014","May","412717","390299","22418","5.4","5.7"
"SUFFOLK COUNTY","2014","June","419869","395718","24151","5.8","5.9"
"SUFFOLK COUNTY","2014","July","422775","397341","25434","6.0","6.1"
"SUFFOLK COUNTY","2014","August","420769","397249","23520","5.6","5.7"
"SUFFOLK COUNTY","2014","September","414313","392288","22025","5.3","5.5"
"SUFFOLK COUNTY","2014","October","419760","399356","20404","4.9","5.0"
"SUFFOLK COUNTY","2014","November","420989","401509","19480","4.6","4.9"
"SUFFOLK COUNTY","2014","December","418418","400329","18089","4.3","4.8"
"SUFFOLK COUNTY","2014","Annual","415644","393729","21915","5.3","5.7"
"SUFFOLK COUNTY","2013","January","404452","377682","26770","6.6","7.6"
"SUFFOLK COUNTY","2013","February","402688","378366","24322","6.0","7.2"
"SUFFOLK COUNTY","2013","March","403188","380062","23126","5.7","6.9"
"SUFFOLK COUNTY","2013","April","404413","381759","22654","5.6","6.3"
"SUFFOLK COUNTY","2013","May","406335","380722","25613","6.3","6.6"
"SUFFOLK COUNTY","2013","June","413502","384736","28766","7.0","7.1"
"SUFFOLK COUNTY","2013","July","414686","385979","28707","6.9","7.0"
"SUFFOLK COUNTY","2013","August","412938","386329","26609","6.4","6.5"
"SUFFOLK COUNTY","2013","September","406071","380583","25488","6.3","6.5"
"SUFFOLK COUNTY","2013","October","405834","381858","23976","5.9","6.2"
"SUFFOLK COUNTY","2013","November","407719","385636","22083","5.4","5.9"
"SUFFOLK COUNTY","2013","December","406081","384844","21237","5.2","5.9"
"SUFFOLK COUNTY","2013","Annual","407326","382380","24946","6.1","6.6"
"SUFFOLK COUNTY","2012","January","399678","373713","25965","6.5","7.4"
"SUFFOLK COUNTY","2012","February","400030","375335","24695","6.2","7.3"
"SUFFOLK COUNTY","2012","March","400877","377492","23385","5.8","6.9"
"SUFFOLK COUNTY","2012","April","400033","377421","22612","5.7","6.3"
"SUFFOLK COUNTY","2012","May","401243","376932","24311","6.1","6.5"
"SUFFOLK COUNTY","2012","June","408837","381347","27490","6.7","6.9"
"SUFFOLK COUNTY","2012","July","409740","381386","28354","6.9","7.1"
"SUFFOLK COUNTY","2012","August","408481","381960","26521","6.5","6.7"
"SUFFOLK COUNTY","2012","September","402555","377357","25198","6.3","6.5"
"SUFFOLK COUNTY","2012","October","406005","381760","24245","6.0","6.3"
"SUFFOLK COUNTY","2012","November","404806","381980","22826","5.6","6.1"
"SUFFOLK COUNTY","2012","December","403636","380599","23037","5.7","6.4"
"SUFFOLK COUNTY","2012","Annual","403827","378940","24887","6.2","6.7"
"SUFFOLK COUNTY","2011","January","394603","365985","28618","7.3","8.3"
"SUFFOLK COUNTY","2011","February","393518","366651","26867","6.8","8.0"
"SUFFOLK COUNTY","2011","March","394932","369646","25286","6.4","7.6"
"SUFFOLK COUNTY","2011","April","395305","370814","24491","6.2","7.0"
"SUFFOLK COUNTY","2011","May","394119","368463","25656","6.5","7.1"
"SUFFOLK COUNTY","2011","June","400132","371238","28894","7.2","7.5"
"SUFFOLK COUNTY","2011","July","402648","373306","29342","7.3","7.5"
"SUFFOLK COUNTY","2011","August","403930","376562","27368","6.8","7.0"
"SUFFOLK COUNTY","2011","September","397804","370583","27221","6.8","7.1"
"SUFFOLK COUNTY","2011","October","399635","374599","25036","6.3","6.6"
"SUFFOLK COUNTY","2011","November","399994","376460","23534","5.9","6.4"
"SUFFOLK COUNTY","2011","December","399557","376148","23409","5.9","6.5"
"SUFFOLK COUNTY","2011","Annual","398015","371705","26310","6.6","7.2"
"SUFFOLK COUNTY","2010","January","390539","358991","31548","8.1","9.3"
"SUFFOLK COUNTY","2010","February","390381","360343","30038","7.7","9.1"
"SUFFOLK COUNTY","2010","March","391911","363056","28855","7.4","8.7"
"SUFFOLK COUNTY","2010","April","392555","364723","27832","7.1","8.0"
"SUFFOLK COUNTY","2010","May","391609","363039","28570","7.3","7.9"
"SUFFOLK COUNTY","2010","June","397740","366641","31099","7.8","8.1"
"SUFFOLK COUNTY","2010","July","399327","367609","31718","7.9","8.1"
"SUFFOLK COUNTY","2010","August","398615","368844","29771","7.5","7.7"
"SUFFOLK COUNTY","2010","September","391765","362432","29333","7.5","7.8"
"SUFFOLK COUNTY","2010","October","393702","366027","27675","7.0","7.3"
"SUFFOLK COUNTY","2010","November","394765","367157","27608","7.0","7.5"
"SUFFOLK COUNTY","2010","December","393854","367416","26438","6.7","7.4"
"SUFFOLK COUNTY","2010","Annual","393897","364690","29207","7.4","8.1"
"SUFFOLK COUNTY","2009","January","373134","345949","27185","7.3","7.8"
"SUFFOLK COUNTY","2009","February","372010","345399","26611","7.2","8.1"
"SUFFOLK COUNTY","2009","March","371396","345867","25529","6.9","8.1"
"SUFFOLK COUNTY","2009","April","371566","346648","24918","6.7","7.5"
"SUFFOLK COUNTY","2009","May","371229","343847","27382","7.4","8.0"
"SUFFOLK COUNTY","2009","June","379529","347939","31590","8.3","8.4"
"SUFFOLK COUNTY","2009","July","380787","348961","31826","8.4","8.5"
"SUFFOLK COUNTY","2009","August","379360","348449","30911","8.1","8.2"
"SUFFOLK COUNTY","2009","September","372758","340827","31931","8.6","8.4"
"SUFFOLK COUNTY","2009","October","373800","343827","29973","8.0","8.1"
"SUFFOLK COUNTY","2009","November","375802","345898","29904","8.0","7.9"
"SUFFOLK COUNTY","2009","December","372989","343345","29644","7.9","8.2"
"SUFFOLK COUNTY","2009","Annual","374530","345580","28950","7.7","8.1"
"SUFFOLK COUNTY","2008","January","367850","349532","18318","5.0","5.2"
"SUFFOLK COUNTY","2008","February","366260","349242","17018","4.6","5.1"
"SUFFOLK COUNTY","2008","March","367205","350582","16623","4.5","4.9"
"SUFFOLK COUNTY","2008","April","366920","351230","15690","4.3","4.4"
"SUFFOLK COUNTY","2008","May","368158","349089","19069","5.2","4.9"
"SUFFOLK COUNTY","2008","June","376394","354105","22289","5.9","5.3"
"SUFFOLK COUNTY","2008","July","377619","355428","22191","5.9","5.5"
"SUFFOLK COUNTY","2008","August","376819","355335","21484","5.7","5.4"
"SUFFOLK COUNTY","2008","September","371592","348831","22761","6.1","5.5"
"SUFFOLK COUNTY","2008","October","374221","352622","21599","5.8","5.4"
"SUFFOLK COUNTY","2008","November","375284","352788","22496","6.0","5.7"
"SUFFOLK COUNTY","2008","December","373764","350697","23067","6.2","6.3"
"SUFFOLK COUNTY","2008","Annual","371840","351623","20217","5.4","5.3"
"SUFFOLK COUNTY","2007","January","362866","343582","19284","5.3","5.4"
"SUFFOLK COUNTY","2007","February","361377","343888","17489","4.8","5.1"
"SUFFOLK COUNTY","2007","March","361744","345935","15809","4.4","4.7"
"SUFFOLK COUNTY","2007","April","360597","345212","15385","4.3","4.3"
"SUFFOLK COUNTY","2007","May","360678","344110","16568","4.6","4.3"
"SUFFOLK COUNTY","2007","June","368223","349074","19149","5.2","4.6"
"SUFFOLK COUNTY","2007","July","369055","350860","18195","4.9","4.7"
"SUFFOLK COUNTY","2007","August","367199","350915","16284","4.4","4.3"
"SUFFOLK COUNTY","2007","September","362687","345668","17019","4.7","4.4"
"SUFFOLK COUNTY","2007","October","364371","349409","14962","4.1","4.0"
"SUFFOLK COUNTY","2007","November","367185","351754","15431","4.2","4.0"
"SUFFOLK COUNTY","2007","December","365423","349974","15449","4.2","4.3"
"SUFFOLK COUNTY","2007","Annual","364284","347532","16752","4.6","4.5"
"SUFFOLK COUNTY","2006","January","353279","334335","18944","5.4","5.3"
"SUFFOLK COUNTY","2006","February","353834","335094","18740","5.3","5.3"
"SUFFOLK COUNTY","2006","March","354244","336491","17753","5.0","5.0"
"SUFFOLK COUNTY","2006","April","353579","335561","18018","5.1","4.6"
"SUFFOLK COUNTY","2006","May","353958","335730","18228","5.1","4.6"
"SUFFOLK COUNTY","2006","June","362070","341615","20455","5.6","4.8"
"SUFFOLK COUNTY","2006","July","362889","342955","19934","5.5","5.0"
"SUFFOLK COUNTY","2006","August","362784","344077","18707","5.2","4.6"
"SUFFOLK COUNTY","2006","September","356708","337818","18890","5.3","4.7"
"SUFFOLK COUNTY","2006","October","359534","343102","16432","4.6","4.1"
"SUFFOLK COUNTY","2006","November","361786","344495","17291","4.8","4.3"
"SUFFOLK COUNTY","2006","December","360989","344506","16483","4.6","4.3"
"SUFFOLK COUNTY","2006","Annual","357971","339648","18323","5.1","4.7"
"SUFFOLK COUNTY","2005","January","329910","311224","18686","5.7","5.5"
"SUFFOLK COUNTY","2005","February","329794","311715","18079","5.5","5.5"
"SUFFOLK COUNTY","2005","March","330014","312871","17143","5.2","5.1"
"SUFFOLK COUNTY","2005","April","329187","312703","16484","5.0","4.6"
"SUFFOLK COUNTY","2005","May","328902","312026","16876","5.1","4.7"
"SUFFOLK COUNTY","2005","June","335218","315809","19409","5.8","4.9"
"SUFFOLK COUNTY","2005","July","336411","317515","18896","5.6","4.9"
"SUFFOLK COUNTY","2005","August","335854","318555","17299","5.2","4.5"
"SUFFOLK COUNTY","2005","September","330160","311474","18686","5.7","4.8"
"SUFFOLK COUNTY","2005","October","332768","315945","16823","5.1","4.3"
"SUFFOLK COUNTY","2005","November","333993","316418","17575","5.3","4.5"
"SUFFOLK COUNTY","2005","December","332777","316211","16566","5.0","4.5"
"SUFFOLK COUNTY","2005","Annual","332082","314372","17710","5.3","4.8"
"SUFFOLK COUNTY","2004","January","338631","316852","21779","6.4","6.1"
"SUFFOLK COUNTY","2004","February","337279","317385","19894","5.9","5.8"
"SUFFOLK COUNTY","2004","March","337090","317347","19743","5.9","5.7"
"SUFFOLK COUNTY","2004","April","335238","316814","18424","5.5","5.0"
"SUFFOLK COUNTY","2004","May","334134","315074","19060","5.7","5.0"
"SUFFOLK COUNTY","2004","June","340533","319094","21439","6.3","5.4"
"SUFFOLK COUNTY","2004","July","341584","320668","20916","6.1","5.3"
"SUFFOLK COUNTY","2004","August","339801","320546","19255","5.7","4.8"
"SUFFOLK COUNTY","2004","September","332808","313968","18840","5.7","4.8"
"SUFFOLK COUNTY","2004","October","334833","317910","16923","5.1","4.4"
"SUFFOLK COUNTY","2004","November","336349","319534","16815","5.0","4.5"
"SUFFOLK COUNTY","2004","December","335169","318771","16398","4.9","4.5"
"SUFFOLK COUNTY","2004","Annual","336954","317830","19124","5.7","5.1"
"SUFFOLK COUNTY","2003","January","346845","323762","23083","6.7","6.3"
"SUFFOLK COUNTY","2003","February","345820","323883","21937","6.3","6.1"
"SUFFOLK COUNTY","2003","March","346396","324435","21961","6.3","6.0"
"SUFFOLK COUNTY","2003","April","345614","324188","21426","6.2","5.5"
"SUFFOLK COUNTY","2003","May","343945","321580","22365","6.5","5.7"
"SUFFOLK COUNTY","2003","June","350317","324991","25326","7.2","6.2"
"SUFFOLK COUNTY","2003","July","349011","324473","24538","7.0","6.0"
"SUFFOLK COUNTY","2003","August","347949","324251","23698","6.8","5.6"
"SUFFOLK COUNTY","2003","September","341854","318753","23101","6.8","5.7"
"SUFFOLK COUNTY","2003","October","343471","322805","20666","6.0","5.2"
"SUFFOLK COUNTY","2003","November","344937","324582","20355","5.9","5.2"
"SUFFOLK COUNTY","2003","December","343336","324048","19288","5.6","5.1"
"SUFFOLK COUNTY","2003","Annual","345791","323479","22312","6.5","5.7"
"SUFFOLK COUNTY","2002","January","349550","328986","20564","5.9","5.6"
"SUFFOLK COUNTY","2002","February","351093","331431","19662","5.6","5.4"
"SUFFOLK COUNTY","2002","March","351841","331718","20123","5.7","5.4"
"SUFFOLK COUNTY","2002","April","350775","330793","19982","5.7","5.0"
"SUFFOLK COUNTY","2002","May","350056","329850","20206","5.8","4.9"
"SUFFOLK COUNTY","2002","June","355819","333099","22720","6.4","5.4"
"SUFFOLK COUNTY","2002","July","356367","333759","22608","6.3","5.4"
"SUFFOLK COUNTY","2002","August","356191","334600","21591","6.1","5.1"
"SUFFOLK COUNTY","2002","September","351220","329254","21966","6.3","5.2"
"SUFFOLK COUNTY","2002","October","352331","332379","19952","5.7","4.9"
"SUFFOLK COUNTY","2002","November","352894","332277","20617","5.8","5.1"
"SUFFOLK COUNTY","2002","December","351996","331437","20559","5.8","5.3"
"SUFFOLK COUNTY","2002","Annual","352511","331632","20879","5.9","5.2"
"SUFFOLK COUNTY","2001","January","349758","336671","13087","3.7","3.7"
"SUFFOLK COUNTY","2001","February","350180","337720","12460","3.6","3.5"
"SUFFOLK COUNTY","2001","March","352187","339164","13023","3.7","3.6"
"SUFFOLK COUNTY","2001","April","349387","337262","12125","3.5","3.2"
"SUFFOLK COUNTY","2001","May","348512","335561","12951","3.7","3.3"
"SUFFOLK COUNTY","2001","June","354475","338921","15554","4.4","3.8"
"SUFFOLK COUNTY","2001","July","356532","340623","15909","4.5","3.9"
"SUFFOLK COUNTY","2001","August","354572","339006","15566","4.4","3.9"
"SUFFOLK COUNTY","2001","September","349440","333199","16241","4.6","4.0"
"SUFFOLK COUNTY","2001","October","351757","336120","15637","4.4","4.0"
"SUFFOLK COUNTY","2001","November","353043","336803","16240","4.6","4.2"
"SUFFOLK COUNTY","2001","December","353651","336640","17011","4.8","4.4"
"SUFFOLK COUNTY","2001","Annual","351958","337308","14650","4.2","3.8"
"WORCESTER COUNTY","2020","January","450641","433640","17001","3.8","3.5"
"WORCESTER COUNTY","2020","February","450386","434383","16003","3.6","3.3"
"WORCESTER COUNTY","2020","March","444872","428118","16754","3.8","3.6"
"WORCESTER COUNTY","2020","April","407030","340600","66430","16.3","16.7"
"WORCESTER COUNTY","2020","May","431748","366933","64815","15.0","15.6"
"WORCESTER COUNTY","2020","June","447111","384086","63025","14.1","14.5"
"WORCESTER COUNTY","2020","July","447370","389763","57607","12.9","13.0"
"WORCESTER COUNTY","2020","August","446914","401223","45691","10.2","10.3"
"WORCESTER COUNTY","2020","September","442275","399642","42633","9.6","9.8"
"WORCESTER COUNTY","2020","October","445804","409887","35917","8.1","8.1"
"WORCESTER COUNTY","2020","November","445775","411854","33921","7.6","7.6"
"WORCESTER COUNTY","2020","December","445415","412164","33251","7.5","7.4"
"WORCESTER COUNTY","2020","Annual","442111","401024","41087","9.3","9.4"
"WORCESTER COUNTY","2019","January","453637","434548","19089","4.2","4.0"
"WORCESTER COUNTY","2019","February","454421","436688","17733","3.9","3.6"
"WORCESTER COUNTY","2019","March","453629","436968","16661","3.7","3.4"
"WORCESTER COUNTY","2019","April","450356","436851","13505","3.0","2.8"
"WORCESTER COUNTY","2019","May","449659","435468","14191","3.2","2.9"
"WORCESTER COUNTY","2019","June","453218","437504","15714","3.5","3.2"
"WORCESTER COUNTY","2019","July","451195","434731","16464","3.6","3.3"
"WORCESTER COUNTY","2019","August","450439","435555","14884","3.3","3.0"
"WORCESTER COUNTY","2019","September","446740","433015","13725","3.1","2.8"
"WORCESTER COUNTY","2019","October","449690","437128","12562","2.8","2.6"
"WORCESTER COUNTY","2019","November","450848","438603","12245","2.7","2.5"
"WORCESTER COUNTY","2019","December","450896","437918","12978","2.9","2.6"
"WORCESTER COUNTY","2019","Annual","451227","436248","14979","3.3","3.1"
"WORCESTER COUNTY","2018","January","446047","426334","19713","4.4","4.3"
"WORCESTER COUNTY","2018","February","450175","430675","19500","4.3","4.2"
"WORCESTER COUNTY","2018","March","451472","433401","18071","4.0","3.8"
"WORCESTER COUNTY","2018","April","450138","434340","15798","3.5","3.3"
"WORCESTER COUNTY","2018","May","451162","435512","15650","3.5","3.3"
"WORCESTER COUNTY","2018","June","455156","437013","18143","4.0","3.7"
"WORCESTER COUNTY","2018","July","453410","435340","18070","4.0","3.7"
"WORCESTER COUNTY","2018","August","451036","434678","16358","3.6","3.3"
"WORCESTER COUNTY","2018","September","449285","434061","15224","3.4","3.2"
"WORCESTER COUNTY","2018","October","451598","437704","13894","3.1","2.9"
"WORCESTER COUNTY","2018","November","453742","440592","13150","2.9","2.8"
"WORCESTER COUNTY","2018","December","454523","439965","14558","3.2","3.0"
"WORCESTER COUNTY","2018","Annual","451479","434968","16511","3.7","3.4"
"WORCESTER COUNTY","2017","January","439167","418580","20587","4.7","4.5"
"WORCESTER COUNTY","2017","February","440737","420619","20118","4.6","4.4"
"WORCESTER COUNTY","2017","March","443293","424611","18682","4.2","4.0"
"WORCESTER COUNTY","2017","April","440694","423929","16765","3.8","3.6"
"WORCESTER COUNTY","2017","May","440027","422791","17236","3.9","3.7"
"WORCESTER COUNTY","2017","June","444407","425674","18733","4.2","4.0"
"WORCESTER COUNTY","2017","July","443923","424256","19667","4.4","4.1"
"WORCESTER COUNTY","2017","August","443152","424972","18180","4.1","3.8"
"WORCESTER COUNTY","2017","September","441597","424612","16985","3.8","3.7"
"WORCESTER COUNTY","2017","October","441607","426288","15319","3.5","3.3"
"WORCESTER COUNTY","2017","November","444538","429399","15139","3.4","3.3"
"WORCESTER COUNTY","2017","December","445576","430012","15564","3.5","3.4"
"WORCESTER COUNTY","2017","Annual","442393","424645","17748","4.0","3.8"
"WORCESTER COUNTY","2016","January","426795","404903","21892","5.1","4.9"
"WORCESTER COUNTY","2016","February","428852","407626","21226","4.9","4.7"
"WORCESTER COUNTY","2016","March","431054","410615","20439","4.7","4.5"
"WORCESTER COUNTY","2016","April","429164","411310","17854","4.2","3.9"
"WORCESTER COUNTY","2016","May","427683","410348","17335","4.1","3.9"
"WORCESTER COUNTY","2016","June","432970","413682","19288","4.5","4.2"
"WORCESTER COUNTY","2016","July","432408","412713","19695","4.6","4.2"
"WORCESTER COUNTY","2016","August","431773","413872","17901","4.1","3.8"
"WORCESTER COUNTY","2016","September","428253","410738","17515","4.1","3.8"
"WORCESTER COUNTY","2016","October","429113","413469","15644","3.6","3.5"
"WORCESTER COUNTY","2016","November","431160","416277","14883","3.5","3.3"
"WORCESTER COUNTY","2016","December","431200","415436","15764","3.7","3.5"
"WORCESTER COUNTY","2016","Annual","430035","411749","18286","4.3","4.0"
"WORCESTER COUNTY","2015","January","429237","403353","25884","6.0","5.8"
"WORCESTER COUNTY","2015","February","429733","404871","24862","5.8","5.5"
"WORCESTER COUNTY","2015","March","429758","406258","23500","5.5","5.2"
"WORCESTER COUNTY","2015","April","428176","406907","21269","5.0","4.6"
"WORCESTER COUNTY","2015","May","429122","406873","22249","5.2","4.9"
"WORCESTER COUNTY","2015","June","432549","409707","22842","5.3","5.0"
"WORCESTER COUNTY","2015","July","428032","404559","23473","5.5","5.0"
"WORCESTER COUNTY","2015","August","426826","405859","20967","4.9","4.5"
"WORCESTER COUNTY","2015","September","420317","400213","20104","4.8","4.5"
"WORCESTER COUNTY","2015","October","423990","405325","18665","4.4","4.2"
"WORCESTER COUNTY","2015","November","425485","407300","18185","4.3","4.1"
"WORCESTER COUNTY","2015","December","426977","408582","18395","4.3","4.1"
"WORCESTER COUNTY","2015","Annual","427517","405817","21700","5.1","4.8"
"WORCESTER COUNTY","2014","January","421779","391916","29863","7.1","6.7"
"WORCESTER COUNTY","2014","February","423960","394164","29796","7.0","6.7"
"WORCESTER COUNTY","2014","March","426797","397767","29030","6.8","6.4"
"WORCESTER COUNTY","2014","April","422913","398375","24538","5.8","5.5"
"WORCESTER COUNTY","2014","May","424604","398753","25851","6.1","5.7"
"WORCESTER COUNTY","2014","June","430158","403230","26928","6.3","5.9"
"WORCESTER COUNTY","2014","July","429481","401085","28396","6.6","6.1"
"WORCESTER COUNTY","2014","August","428152","401845","26307","6.1","5.7"
"WORCESTER COUNTY","2014","September","424260","399464","24796","5.8","5.5"
"WORCESTER COUNTY","2014","October","428827","406219","22608","5.3","5.0"
"WORCESTER COUNTY","2014","November","430613","408305","22308","5.2","4.9"
"WORCESTER COUNTY","2014","December","429467","407771","21696","5.1","4.8"
"WORCESTER COUNTY","2014","Annual","426751","400741","26010","6.1","5.7"
"WORCESTER COUNTY","2013","January","421401","387431","33970","8.1","7.6"
"WORCESTER COUNTY","2013","February","420497","388066","32431","7.7","7.2"
"WORCESTER COUNTY","2013","March","421121","389969","31152","7.4","6.9"
"WORCESTER COUNTY","2013","April","419879","391214","28665","6.8","6.3"
"WORCESTER COUNTY","2013","May","421088","391404","29684","7.0","6.6"
"WORCESTER COUNTY","2013","June","426625","394507","32118","7.5","7.1"
"WORCESTER COUNTY","2013","July","423837","391808","32029","7.6","7.0"
"WORCESTER COUNTY","2013","August","423200","393369","29831","7.0","6.5"
"WORCESTER COUNTY","2013","September","417165","388087","29078","7.0","6.5"
"WORCESTER COUNTY","2013","October","416907","389455","27452","6.6","6.2"
"WORCESTER COUNTY","2013","November","419452","392998","26454","6.3","5.9"
"WORCESTER COUNTY","2013","December","419584","393405","26179","6.2","5.9"
"WORCESTER COUNTY","2013","Annual","420896","390976","29920","7.1","6.6"
"WORCESTER COUNTY","2012","January","419330","386715","32615","7.8","7.4"
"WORCESTER COUNTY","2012","February","419326","387029","32297","7.7","7.3"
"WORCESTER COUNTY","2012","March","421349","390201","31148","7.4","6.9"
"WORCESTER COUNTY","2012","April","417319","389061","28258","6.8","6.3"
"WORCESTER COUNTY","2012","May","418793","388983","29810","7.1","6.5"
"WORCESTER COUNTY","2012","June","426051","394018","32033","7.5","6.9"
"WORCESTER COUNTY","2012","July","423152","390230","32922","7.8","7.1"
"WORCESTER COUNTY","2012","August","422172","391208","30964","7.3","6.7"
"WORCESTER COUNTY","2012","September","418238","388813","29425","7.0","6.5"
"WORCESTER COUNTY","2012","October","420671","392669","28002","6.7","6.3"
"WORCESTER COUNTY","2012","November","419818","392178","27640","6.6","6.1"
"WORCESTER COUNTY","2012","December","419873","390711","29162","6.9","6.4"
"WORCESTER COUNTY","2012","Annual","420507","390151","30356","7.2","6.7"
"WORCESTER COUNTY","2011","January","420477","383816","36661","8.7","8.3"
"WORCESTER COUNTY","2011","February","419205","384008","35197","8.4","8.0"
"WORCESTER COUNTY","2011","March","420120","386256","33864","8.1","7.6"
"WORCESTER COUNTY","2011","April","418115","386848","31267","7.5","7.0"
"WORCESTER COUNTY","2011","May","417009","385358","31651","7.6","7.1"
"WORCESTER COUNTY","2011","June","421970","388167","33803","8.0","7.5"
"WORCESTER COUNTY","2011","July","420590","386771","33819","8.0","7.5"
"WORCESTER COUNTY","2011","August","421522","389253","32269","7.7","7.0"
"WORCESTER COUNTY","2011","September","417606","385849","31757","7.6","7.1"
"WORCESTER COUNTY","2011","October","419321","390003","29318","7.0","6.6"
"WORCESTER COUNTY","2011","November","420367","392067","28300","6.7","6.4"
"WORCESTER COUNTY","2011","December","420643","391742","28901","6.9","6.5"
"WORCESTER COUNTY","2011","Annual","419746","387512","32234","7.7","7.2"
"WORCESTER COUNTY","2010","January","419312","378573","40739","9.7","9.3"
"WORCESTER COUNTY","2010","February","418406","378623","39783","9.5","9.1"
"WORCESTER COUNTY","2010","March","419348","380574","38774","9.2","8.7"
"WORCESTER COUNTY","2010","April","419363","383896","35467","8.5","8.0"
"WORCESTER COUNTY","2010","May","419192","383424","35768","8.5","7.9"
"WORCESTER COUNTY","2010","June","424323","387789","36534","8.6","8.1"
"WORCESTER COUNTY","2010","July","423434","386092","37342","8.8","8.1"
"WORCESTER COUNTY","2010","August","423469","387729","35740","8.4","7.7"
"WORCESTER COUNTY","2010","September","417073","382427","34646","8.3","7.8"
"WORCESTER COUNTY","2010","October","418393","386028","32365","7.7","7.3"
"WORCESTER COUNTY","2010","November","420059","387099","32960","7.8","7.5"
"WORCESTER COUNTY","2010","December","421330","388353","32977","7.8","7.4"
"WORCESTER COUNTY","2010","Annual","420308","384217","36091","8.6","8.1"
"WORCESTER COUNTY","2009","January","405796","371798","33998","8.4","7.8"
"WORCESTER COUNTY","2009","February","404538","370362","34176","8.4","8.1"
"WORCESTER COUNTY","2009","March","404634","370658","33976","8.4","8.1"
"WORCESTER COUNTY","2009","April","404314","371624","32690","8.1","7.5"
"WORCESTER COUNTY","2009","May","404335","369974","34361","8.5","8.0"
"WORCESTER COUNTY","2009","June","411020","373302","37718","9.2","8.4"
"WORCESTER COUNTY","2009","July","409508","370603","38905","9.5","8.5"
"WORCESTER COUNTY","2009","August","408255","370707","37548","9.2","8.2"
"WORCESTER COUNTY","2009","September","402635","364355","38280","9.5","8.4"
"WORCESTER COUNTY","2009","October","405082","368304","36778","9.1","8.1"
"WORCESTER COUNTY","2009","November","406576","369917","36659","9.0","7.9"
"WORCESTER COUNTY","2009","December","405882","368463","37419","9.2","8.2"
"WORCESTER COUNTY","2009","Annual","406048","370006","36042","8.9","8.1"
"WORCESTER COUNTY","2008","January","402213","378696","23517","5.8","5.2"
"WORCESTER COUNTY","2008","February","400189","377773","22416","5.6","5.1"
"WORCESTER COUNTY","2008","March","401141","379052","22089","5.5","4.9"
"WORCESTER COUNTY","2008","April","399031","378886","20145","5.0","4.4"
"WORCESTER COUNTY","2008","May","399490","377671","21819","5.5","4.9"
"WORCESTER COUNTY","2008","June","406766","382157","24609","6.0","5.3"
"WORCESTER COUNTY","2008","July","404734","379031","25703","6.4","5.5"
"WORCESTER COUNTY","2008","August","404864","379626","25238","6.2","5.4"
"WORCESTER COUNTY","2008","September","401773","375823","25950","6.5","5.5"
"WORCESTER COUNTY","2008","October","404515","379580","24935","6.2","5.4"
"WORCESTER COUNTY","2008","November","405747","379245","26502","6.5","5.7"
"WORCESTER COUNTY","2008","December","404589","376033","28556","7.1","6.3"
"WORCESTER COUNTY","2008","Annual","402921","378631","24290","6.0","5.3"
"WORCESTER COUNTY","2007","January","403147","378690","24457","6.1","5.4"
"WORCESTER COUNTY","2007","February","400616","377890","22726","5.7","5.1"
"WORCESTER COUNTY","2007","March","401695","380609","21086","5.2","4.7"
"WORCESTER COUNTY","2007","April","398702","379000","19702","4.9","4.3"
"WORCESTER COUNTY","2007","May","399472","380166","19306","4.8","4.3"
"WORCESTER COUNTY","2007","June","407023","385494","21529","5.3","4.6"
"WORCESTER COUNTY","2007","July","402448","380729","21719","5.4","4.7"
"WORCESTER COUNTY","2007","August","401034","381451","19583","4.9","4.3"
"WORCESTER COUNTY","2007","September","398056","378552","19504","4.9","4.4"
"WORCESTER COUNTY","2007","October","399742","382537","17205","4.3","4.0"
"WORCESTER COUNTY","2007","November","402969","385023","17946","4.5","4.0"
"WORCESTER COUNTY","2007","December","401589","382260","19329","4.8","4.3"
"WORCESTER COUNTY","2007","Annual","401374","381033","20341","5.1","4.5"
"WORCESTER COUNTY","2006","January","399694","376638","23056","5.8","5.3"
"WORCESTER COUNTY","2006","February","398387","375352","23035","5.8","5.3"
"WORCESTER COUNTY","2006","March","399041","377152","21889","5.5","5.0"
"WORCESTER COUNTY","2006","April","397390","376932","20458","5.1","4.6"
"WORCESTER COUNTY","2006","May","398409","378532","19877","5.0","4.6"
"WORCESTER COUNTY","2006","June","406073","384225","21848","5.4","4.8"
"WORCESTER COUNTY","2006","July","403817","381579","22238","5.5","5.0"
"WORCESTER COUNTY","2006","August","404823","383863","20960","5.2","4.6"
"WORCESTER COUNTY","2006","September","399549","378360","21189","5.3","4.7"
"WORCESTER COUNTY","2006","October","402711","383940","18771","4.7","4.1"
"WORCESTER COUNTY","2006","November","404275","384329","19946","4.9","4.3"
"WORCESTER COUNTY","2006","December","404525","384342","20183","5.0","4.3"
"WORCESTER COUNTY","2006","Annual","401558","380437","21121","5.3","4.7"
"WORCESTER COUNTY","2005","January","398800","374773","24027","6.0","5.5"
"WORCESTER COUNTY","2005","February","397451","374137","23314","5.9","5.5"
"WORCESTER COUNTY","2005","March","397366","375217","22149","5.6","5.1"
"WORCESTER COUNTY","2005","April","396160","375985","20175","5.1","4.6"
"WORCESTER COUNTY","2005","May","396952","377217","19735","5.0","4.7"
"WORCESTER COUNTY","2005","June","403285","381742","21543","5.3","4.9"
"WORCESTER COUNTY","2005","July","400716","379117","21599","5.4","4.9"
"WORCESTER COUNTY","2005","August","399663","380118","19545","4.9","4.5"
"WORCESTER COUNTY","2005","September","395026","374511","20515","5.2","4.8"
"WORCESTER COUNTY","2005","October","398271","379695","18576","4.7","4.3"
"WORCESTER COUNTY","2005","November","399984","380244","19740","4.9","4.5"
"WORCESTER COUNTY","2005","December","398996","379674","19322","4.8","4.5"
"WORCESTER COUNTY","2005","Annual","398556","377703","20853","5.2","4.8"
"WORCESTER COUNTY","2004","January","404674","378142","26532","6.6","6.1"
"WORCESTER COUNTY","2004","February","402336","377323","25013","6.2","5.8"
"WORCESTER COUNTY","2004","March","401894","377484","24410","6.1","5.7"
"WORCESTER COUNTY","2004","April","399429","377879","21550","5.4","5.0"
"WORCESTER COUNTY","2004","May","399493","377788","21705","5.4","5.0"
"WORCESTER COUNTY","2004","June","406628","382811","23817","5.9","5.4"
"WORCESTER COUNTY","2004","July","403028","379675","23353","5.8","5.3"
"WORCESTER COUNTY","2004","August","401808","380541","21267","5.3","4.8"
"WORCESTER COUNTY","2004","September","395528","374953","20575","5.2","4.8"
"WORCESTER COUNTY","2004","October","397442","378671","18771","4.7","4.4"
"WORCESTER COUNTY","2004","November","399512","380521","18991","4.8","4.5"
"WORCESTER COUNTY","2004","December","399003","379677","19326","4.8","4.5"
"WORCESTER COUNTY","2004","Annual","400898","378789","22109","5.5","5.1"
"WORCESTER COUNTY","2003","January","404140","377419","26721","6.6","6.3"
"WORCESTER COUNTY","2003","February","402978","376975","26003","6.5","6.1"
"WORCESTER COUNTY","2003","March","402877","377456","25421","6.3","6.0"
"WORCESTER COUNTY","2003","April","401257","377580","23677","5.9","5.5"
"WORCESTER COUNTY","2003","May","400362","376313","24049","6.0","5.7"
"WORCESTER COUNTY","2003","June","407410","380641","26769","6.6","6.2"
"WORCESTER COUNTY","2003","July","404041","377830","26211","6.5","6.0"
"WORCESTER COUNTY","2003","August","403252","378673","24579","6.1","5.6"
"WORCESTER COUNTY","2003","September","399347","375078","24269","6.1","5.7"
"WORCESTER COUNTY","2003","October","401933","379846","22087","5.5","5.2"
"WORCESTER COUNTY","2003","November","403275","380881","22394","5.6","5.2"
"WORCESTER COUNTY","2003","December","403173","381168","22005","5.5","5.1"
"WORCESTER COUNTY","2003","Annual","402837","378322","24515","6.1","5.7"
"WORCESTER COUNTY","2002","January","396646","374056","22590","5.7","5.6"
"WORCESTER COUNTY","2002","February","398149","375807","22342","5.6","5.4"
"WORCESTER COUNTY","2002","March","397721","375632","22089","5.6","5.4"
"WORCESTER COUNTY","2002","April","397562","376458","21104","5.3","5.0"
"WORCESTER COUNTY","2002","May","398048","377114","20934","5.3","4.9"
"WORCESTER COUNTY","2002","June","404058","380249","23809","5.9","5.4"
"WORCESTER COUNTY","2002","July","401487","377179","24308","6.1","5.4"
"WORCESTER COUNTY","2002","August","402271","378858","23413","5.8","5.1"
"WORCESTER COUNTY","2002","September","399932","376632","23300","5.8","5.2"
"WORCESTER COUNTY","2002","October","400976","379457","21519","5.4","4.9"
"WORCESTER COUNTY","2002","November","401160","379127","22033","5.5","5.1"
"WORCESTER COUNTY","2002","December","401807","379225","22582","5.6","5.3"
"WORCESTER COUNTY","2002","Annual","399985","377483","22502","5.6","5.2"
"WORCESTER COUNTY","2001","January","386814","372797","14017","3.6","3.7"
"WORCESTER COUNTY","2001","February","386391","372630","13761","3.6","3.5"
"WORCESTER COUNTY","2001","March","388819","374482","14337","3.7","3.6"
"WORCESTER COUNTY","2001","April","388069","375290","12779","3.3","3.2"
"WORCESTER COUNTY","2001","May","388754","375798","12956","3.3","3.3"
"WORCESTER COUNTY","2001","June","394885","379296","15589","3.9","3.8"
"WORCESTER COUNTY","2001","July","392277","376079","16198","4.1","3.9"
"WORCESTER COUNTY","2001","August","390678","374625","16053","4.1","3.9"
"WORCESTER COUNTY","2001","September","390419","373865","16554","4.2","4.0"
"WORCESTER COUNTY","2001","October","391981","376447","15534","4.0","4.0"
"WORCESTER COUNTY","2001","November","393880","377242","16638","4.2","4.2"
"WORCESTER COUNTY","2001","December","395055","377541","17514","4.4","4.4"
"WORCESTER COUNTY","2001","Annual","390669","375508","15161","3.9","3.8"

"The labor force estimates for towns with 2010 Census population of less than 1,000 were produced using the BLS methodology, but are not official BLS estimates."

"This workforce product was funded by a grant awarded by the U.S. Department of Labor's Employment and Training Administration. The product was created by the recipient and does not necessarily reflect the official position of the U.S. Department of Labor. The Department of Labor makes no guarantees, warranties, or assurances of any kind, express or implied, with respect to such information, including any information on linked sites and including, but not limited to, accuracy of the information or its completeness, timeliness, usefulness, adequacy, continued availability, or ownership. This product is copyrighted by the institution that created it. Internal use by an organization and/or personal use by an individual for non-commercial purposes is permissible. All other uses require the prior authorization of the copyright owner."
"The Federal Government reserves a paid-up, nonexclusive and irrevocable license to reproduce, publish or otherwise use, and to authorize others to use for federal purposes: i) the copyright in all products developed under the grant, including a subgrant or contract under the grant or subgrant; and ii) any rights of copyright to which the recipient, subrecipient or a contractor purchases ownership under an award (including but not limited to curricula, training models, technical assistance products, and any related materials). Such uses include, but are not limited to, the right to modify and distribute such products worldwide by any means, electronically or otherwise. Federal funds may not be used to pay any royalty or license fee for use of a copyrighted work, or the cost of acquiring by purchase a copyright in a work, where the Department has a license or rights of free use in such work, although they may be used to pay costs for obtaining a copy which is limited to the developer/seller costs of copying and shipping. If revenues are generated through selling products developed with grant funds, including intellectual property, these revenues are program income. Program income must be used in accordance with the provisions of this grant award and 2 CFR 200.307."
